Snapshot_Date,Util_Lines,Util_Complexity,Util_Normalized,Non_Util_Lines,Non_Util_Complexity,Non_Util_Normalized,Util_Lines_No_Tests,Util_Complexity_No_Tests,Util_Normalized_No_Tests,Non_Util_Lines_No_Tests,Non_Util_Complexity_No_Tests,Non_Util_Normalized_No_Tests,Util_Lines_Vuln,Util_Complexity_Vuln,Util_Normalized_Vuln,Non_Util_Lines_Vuln,Non_Util_Complexity_Vuln,Non_Util_Normalized_Vuln,Util_Lines_No_Tests_Vuln,Util_Complexity_No_Tests_Vuln,Util_Normalized_No_Tests_Vuln,Non_Util_Lines_No_Tests_Vuln,Non_Util_Complexity_No_Tests_Vuln,Non_Util_Normalized_No_Tests_Vuln,Util_Lines_Non_Vuln,Util_Complexity_Non_Vuln,Util_Normalized_Non_Vuln,Non_Util_Lines_Non_Vuln,Non_Util_Complexity_Non_Vuln,Non_Util_Normalized_Non_Vuln,Util_Lines_No_Tests_Non_Vuln,Util_Complexity_No_Tests_Non_Vuln,Util_Normalized_No_Tests_Non_Vuln,Non_Util_Lines_No_Tests_Non_Vuln,Non_Util_Complexity_No_Tests_Non_Vuln,Non_Util_Normalized_No_Tests_Non_Vuln
2005-07-13,0,0,0.0,0,0,0.0,0,0,0.0,0,0,0.0,0,0,0.0,0,0,0.0,0,0,0.0,0,0,0.0,0,0,0.0,0,0,0.0,0,0,0.0,0,0,0.0
2005-08-12,1359,112,0.08241353936718175,26516,2528,0.09533866344848393,1359,112,0.08241353936718175,22300,2193,0.0983408071748879,0,0,0.0,0,0,0.0,0,0,0.0,0,0,0.0,1359,112,0.08241353936718175,26516,2528,0.09533866344848393,1359,112,0.08241353936718175,22300,2193,0.0983408071748879
2005-09-11,1366,114,0.08345534407027819,28895,2670,0.09240353002249524,1366,114,0.08345534407027819,24386,2335,0.09575166078897729,0,0,0.0,0,0,0.0,0,0,0.0,0,0,0.0,1366,114,0.08345534407027819,28895,2670,0.09240353002249524,1366,114,0.08345534407027819,24386,2335,0.09575166078897729
2005-10-11,1582,149,0.09418457648546144,30191,2806,0.09294160511410686,1582,149,0.09418457648546144,25608,2465,0.09625898156825992,0,0,0.0,0,0,0.0,0,0,0.0,0,0,0.0,1582,149,0.09418457648546144,30191,2806,0.09294160511410686,1582,149,0.09418457648546144,25608,2465,0.09625898156825992
2005-11-10,2090,185,0.08851674641148326,33920,3016,0.08891509433962264,2090,185,0.08851674641148326,29083,2673,0.09190936285802703,0,0,0.0,0,0,0.0,0,0,0.0,0,0,0.0,2090,185,0.08851674641148326,33920,3016,0.08891509433962264,2090,185,0.08851674641148326,29083,2673,0.09190936285802703
2005-12-10,2379,181,0.07608238755779739,39689,3331,0.083927536597042,2379,181,0.07608238755779739,34197,2986,0.08731760095914846,0,0,0.0,0,0,0.0,0,0,0.0,0,0,0.0,2379,181,0.07608238755779739,39689,3331,0.083927536597042,2379,181,0.07608238755779739,34197,2986,0.08731760095914846
2006-01-09,2393,183,0.07647304638529043,40497,3338,0.08242585870558312,2393,183,0.07647304638529043,34677,2985,0.08608011073622286,0,0,0.0,0,0,0.0,0,0,0.0,0,0,0.0,2393,183,0.07647304638529043,40497,3338,0.08242585870558312,2393,183,0.07647304638529043,34677,2985,0.08608011073622286
2006-02-09,2398,183,0.07631359466221851,40927,3346,0.0817553204486036,2398,183,0.07631359466221851,35093,2997,0.08540164705211865,0,0,0.0,0,0,0.0,0,0,0.0,0,0,0.0,2398,183,0.07631359466221851,40927,3346,0.0817553204486036,2398,183,0.07631359466221851,35093,2997,0.08540164705211865
2006-03-16,2401,184,0.07663473552686381,41285,3349,0.08111905050260385,2401,184,0.07663473552686381,35442,3000,0.08464533604198408,0,0,0.0,0,0,0.0,0,0,0.0,0,0,0.0,2401,184,0.07663473552686381,41285,3349,0.08111905050260385,2401,184,0.07663473552686381,35442,3000,0.08464533604198408
2006-04-21,2672,212,0.07934131736526946,41425,3366,0.08125528062764031,2672,212,0.07934131736526946,35582,3017,0.08479006239109663,0,0,0.0,0,0,0.0,0,0,0.0,0,0,0.0,2672,212,0.07934131736526946,41425,3366,0.08125528062764031,2672,212,0.07934131736526946,35582,3017,0.08479006239109663
2006-05-21,2629,216,0.08216051730696082,49418,3472,0.07025780080132746,2629,216,0.08216051730696082,41894,3116,0.07437819258127655,0,0,0.0,0,0,0.0,0,0,0.0,0,0,0.0,2629,216,0.08216051730696082,49418,3472,0.07025780080132746,2629,216,0.08216051730696082,41894,3116,0.07437819258127655
2006-06-20,2738,236,0.08619430241051863,52251,3636,0.06958718493425964,2738,236,0.08619430241051863,44310,3268,0.07375310313698939,0,0,0.0,0,0,0.0,0,0,0.0,0,0,0.0,2738,236,0.08619430241051863,52251,3636,0.06958718493425964,2738,236,0.08619430241051863,44310,3268,0.07375310313698939
2006-07-20,3640,366,0.10054945054945055,54266,3763,0.06934360372977555,3640,366,0.10054945054945055,45938,3394,0.07388218903739824,0,0,0.0,0,0,0.0,0,0,0.0,0,0,0.0,3640,366,0.10054945054945055,54266,3763,0.06934360372977555,3640,366,0.10054945054945055,45938,3394,0.07388218903739824
2006-08-20,3648,368,0.10087719298245613,55247,3811,0.06898112114684961,3648,368,0.10087719298245613,46850,3432,0.07325506937033084,0,0,0.0,33,7,0.21212121212121213,0,0,0.0,33,7,0.21212121212121213,3648,368,0.10087719298245613,55214,3804,0.06889556996413954,3648,368,0.10087719298245613,46817,3425,0.0731571864920862
2006-09-21,3761,387,0.10289816538154746,56803,3832,0.06746122563949088,3654,368,0.10071154898741105,47547,3465,0.07287526026878667,0,0,0.0,36,9,0.25,0,0,0.0,36,9,0.25,3761,387,0.10289816538154746,56767,3823,0.06734546479468706,3654,368,0.10071154898741105,47511,3456,0.07274104944118204
2006-10-23,3800,393,0.10342105263157894,57082,3867,0.06774464805017344,3693,374,0.10127267803953426,47733,3489,0.07309408585255484,0,0,0.0,36,9,0.25,0,0,0.0,36,9,0.25,3800,393,0.10342105263157894,57046,3858,0.06762963222662413,3693,374,0.10127267803953426,47697,3480,0.07296056355745645
2006-11-22,3857,406,0.10526315789473684,59225,3988,0.06733642887294217,3750,387,0.1032,48621,3599,0.07402151333785813,0,0,0.0,36,9,0.25,0,0,0.0,36,9,0.25,3857,406,0.10526315789473684,59189,3979,0.06722532903073206,3750,387,0.1032,48585,3590,0.07389111865802202
2006-12-22,3877,412,0.1062677327830797,61478,4082,0.06639773577539933,3770,393,0.10424403183023873,49591,3646,0.07352140509366618,0,0,0.0,36,9,0.25,0,0,0.0,36,9,0.25,3877,412,0.1062677327830797,61442,4073,0.06629015982552651,3770,393,0.10424403183023873,49555,3637,0.07339319947533045
2007-01-21,3886,413,0.1062789500772002,63587,4104,0.06454149433060216,3779,394,0.10426038634559408,50634,3675,0.07257968953667496,0,0,0.0,48,10,0.20833333333333334,0,0,0.0,48,10,0.20833333333333334,3886,413,0.1062789500772002,63539,4094,0.06443286800232928,3779,394,0.10426038634559408,50586,3665,0.07245087573636974
2007-02-20,4078,386,0.0946542422756253,66027,4228,0.06403441016553835,3968,367,0.0924899193548387,51901,3755,0.07234928036068669,0,0,0.0,48,10,0.20833333333333334,0,0,0.0,48,10,0.20833333333333334,4078,386,0.0946542422756253,65979,4218,0.06392943209202928,3968,367,0.0924899193548387,51853,3745,0.07222340076755443
2007-03-22,4097,386,0.09421527947278496,69950,4465,0.063831308077198,3987,367,0.09204915976925006,54137,3952,0.07299998152834475,0,0,0.0,61,12,0.19672131147540983,0,0,0.0,61,12,0.19672131147540983,4097,386,0.09421527947278496,69889,4453,0.06371532000744037,3987,367,0.09204915976925006,54076,3940,0.07286041867001997
2007-04-21,4251,398,0.09362502940484592,73676,4551,0.06177045442206417,4141,379,0.09152378652499396,56962,4116,0.0722586987816439,0,0,0.0,61,12,0.19672131147540983,0,0,0.0,61,12,0.19672131147540983,4251,398,0.09362502940484592,73615,4539,0.06165862935543028,4141,379,0.09152378652499396,56901,4104,0.07212527020614752
2007-05-21,7384,796,0.10780065005417118,77039,4705,0.06107296304469165,7244,777,0.10726118166758697,58823,4224,0.0718086462778165,0,0,0.0,61,12,0.19672131147540983,0,0,0.0,61,12,0.19672131147540983,7384,796,0.10780065005417118,76978,4693,0.06096547065395308,7244,777,0.10726118166758697,58762,4212,0.07167897620911473
2007-06-20,7440,806,0.10833333333333334,77756,4735,0.060895622202788206,7268,783,0.1077325261419923,59423,4253,0.07157161368493681,0,0,0.0,61,12,0.19672131147540983,0,0,0.0,61,12,0.19672131147540983,7440,806,0.10833333333333334,77695,4723,0.06078898256001029,7268,783,0.1077325261419923,59362,4241,0.07144301068023315
2007-07-20,7865,850,0.1080737444373808,81279,5024,0.061811784101674476,7576,813,0.10731256599788806,62256,4512,0.07247494217424827,0,0,0.0,61,12,0.19672131147540983,0,0,0.0,61,12,0.19672131147540983,7865,850,0.1080737444373808,81218,5012,0.06171045827279667,7576,813,0.10731256599788806,62195,4500,0.07235308304526088
2007-08-19,7982,858,0.10749185667752444,83747,5120,0.061136518323044405,7682,820,0.10674303566779485,63769,4586,0.07191582116702473,0,0,0.0,61,12,0.19672131147540983,0,0,0.0,61,12,0.19672131147540983,7982,858,0.10749185667752444,83686,5108,0.06103768850225844,7682,820,0.10674303566779485,63708,4574,0.07179632071325422
2007-09-19,8187,865,0.10565530719433248,88430,5482,0.06199253646952392,7753,826,0.10653940410163808,66437,4852,0.07303159384078149,0,0,0.0,76,15,0.19736842105263158,0,0,0.0,76,15,0.19736842105263158,8187,865,0.10565530719433248,88354,5467,0.06187608936777056,7753,826,0.10653940410163808,66361,4837,0.07288919696809873
2007-10-19,8203,858,0.1045958795562599,88943,5518,0.06203973331234611,7769,819,0.10541897284077745,66873,4888,0.07309377476709583,0,0,0.0,77,16,0.2077922077922078,0,0,0.0,77,16,0.2077922077922078,8203,858,0.1045958795562599,88866,5502,0.061913442711498214,7769,819,0.10541897284077745,66796,4872,0.072938499311336
2007-11-18,8543,902,0.10558351867025635,92529,5599,0.06051075878913638,8073,861,0.10665180230397622,69049,4960,0.07183304609769874,540,25,0.046296296296296294,898,32,0.035634743875278395,540,25,0.046296296296296294,898,32,0.035634743875278395,8003,877,0.10958390603523678,91631,5567,0.060754548133273675,7533,836,0.11097836187441922,68151,4928,0.07231001746122581
2007-12-19,8656,924,0.1067467652495379,95559,5701,0.059659477390931255,8107,867,0.10694461576415444,71259,5065,0.07107874093097012,539,25,0.04638218923933209,903,31,0.03433001107419712,539,25,0.04638218923933209,903,31,0.03433001107419712,8117,899,0.1107552051250462,94656,5670,0.05990111561866126,7568,842,0.11125792811839323,70356,5034,0.0715504008186935
2008-01-18,8656,924,0.1067467652495379,95809,5713,0.05962905363796721,8107,867,0.10694461576415444,71300,5077,0.07120617110799439,539,25,0.04638218923933209,903,31,0.03433001107419712,539,25,0.04638218923933209,903,31,0.03433001107419712,8117,899,0.1107552051250462,94906,5682,0.059869765873601245,7568,842,0.11125792811839323,70397,5046,0.07167919087461114
2008-02-18,8667,920,0.10614976347063575,96102,5691,0.05921833052381844,8118,863,0.1063069721606307,71462,5052,0.07069491477988302,544,19,0.034926470588235295,904,31,0.034292035398230086,544,19,0.034926470588235295,904,31,0.034292035398230086,8123,901,0.1109196109811646,95198,5660,0.05945503056786907,7574,844,0.11143385265381568,70558,5021,0.07116131409620455
2008-03-19,8826,927,0.10503059143439837,98065,5776,0.058899709376434,8246,870,0.10550569973320398,72908,5134,0.07041751248148351,543,19,0.034990791896869246,902,30,0.03325942350332594,543,19,0.034990791896869246,902,30,0.03325942350332594,8283,908,0.10962211759024508,97163,5746,0.05913773761617076,7703,851,0.11047643775152538,72006,5104,0.07088298197372442
2008-04-18,8826,927,0.10503059143439837,98556,5774,0.05858598157392751,8246,870,0.10550569973320398,73206,5127,0.0700352430128678,543,19,0.034990791896869246,902,30,0.03325942350332594,543,19,0.034990791896869246,902,30,0.03325942350332594,8283,908,0.10962211759024508,97654,5744,0.05881991521084646,7703,851,0.11047643775152538,72304,5097,0.07049402522682009
2008-05-18,9010,933,0.10355160932297447,102507,5664,0.05525476308935,8430,876,0.10391459074733096,75937,5011,0.06598891186114805,543,19,0.034990791896869246,1020,56,0.054901960784313725,543,19,0.034990791896869246,1020,56,0.054901960784313725,8467,914,0.10794850596433211,101487,5608,0.055258308945973375,7887,857,0.10865981995689108,74917,4955,0.06613986144666764
2008-06-17,9014,939,0.10417128910583537,103826,5726,0.05514996243715447,8434,882,0.10457671330329618,76536,5056,0.06606041601337932,543,19,0.034990791896869246,1021,56,0.05484818805093046,543,19,0.034990791896869246,1021,56,0.05484818805093046,8471,920,0.10860583166096092,102805,5670,0.055152959486406306,7891,863,0.10936509948042074,75515,5000,0.06621201085876978
2008-07-17,9231,1001,0.10843895569277434,108888,5924,0.05440452575123062,8623,940,0.10901078510959063,79119,5164,0.06526877235556566,552,39,0.07065217391304347,985,43,0.04365482233502538,552,39,0.07065217391304347,985,43,0.04365482233502538,8679,962,0.11084226293351769,107903,5881,0.05450265516250707,8071,901,0.1116342460661628,78134,5121,0.06554124964804055
2008-08-16,11195,1160,0.10361768646717284,133992,7790,0.0581377992715983,10644,1140,0.10710259301014656,94032,6532,0.0694657137995576,541,35,0.06469500924214418,1019,49,0.04808635917566242,541,35,0.06469500924214418,1019,49,0.04808635917566242,10654,1125,0.10559414304486578,132973,7741,0.058214825566092365,10103,1105,0.10937345342967436,93013,6483,0.06969993441776956
2008-09-15,11820,1267,0.1071912013536379,141571,7764,0.05484174018690269,11257,1247,0.11077551745580527,98534,6471,0.06567276270119958,543,31,0.0570902394106814,2001,97,0.04847576211894053,543,31,0.0570902394106814,1405,97,0.06903914590747331,11277,1236,0.10960361798350625,139570,7667,0.05493300852618758,10714,1216,0.11349635990293075,97129,6374,0.06562406696249318
2008-10-17,11823,1268,0.10724858326989765,142847,7797,0.054582875384152275,11260,1248,0.1108348134991119,99349,6495,0.06537559512425893,543,31,0.0570902394106814,2056,99,0.04815175097276265,543,31,0.0570902394106814,1411,99,0.07016300496102056,11280,1237,0.10966312056737589,140791,7698,0.05467679041984218,10717,1217,0.11355789866567137,97938,6396,0.06530662255712798
2008-11-16,11891,1283,0.10789672861828274,145408,7797,0.05362153389084507,11321,1263,0.11156258281070577,101245,6484,0.0640426687737666,543,31,0.0570902394106814,2099,99,0.04716531681753216,543,31,0.0570902394106814,1413,99,0.07006369426751592,11348,1252,0.11032781106802961,143309,7698,0.05371609598838872,10778,1232,0.11430692150677306,99832,6385,0.06395744851350268
2008-12-16,11898,1283,0.10783324928559422,146537,7841,0.053508670165214246,11328,1263,0.1114936440677966,101820,6525,0.06408367707719505,543,31,0.0570902394106814,2150,99,0.046046511627906975,543,31,0.0570902394106814,1413,99,0.07006369426751592,11355,1252,0.110259797446059,144387,7742,0.05361978571478042,10785,1232,0.11423273064441354,100407,6426,0.06399952194568108
2009-01-15,11903,1395,0.11719734520709064,149358,7936,0.053134080531340805,11333,1375,0.12132709785581929,103438,6612,0.06392234962006225,543,31,0.0570902394106814,2227,105,0.04714863044454423,543,31,0.0570902394106814,1504,105,0.06981382978723404,11360,1364,0.12007042253521127,147131,7831,0.053224677328367234,10790,1344,0.12455977757182576,101934,6507,0.0638354229207134
2009-02-15,11913,1397,0.1172668513388735,150959,7998,0.05298127306089733,11343,1377,0.12139645596403068,104195,6657,0.06388982196842459,543,31,0.0570902394106814,2227,105,0.04714863044454423,543,31,0.0570902394106814,1504,105,0.06981382978723404,11370,1366,0.12014072119613017,148732,7893,0.053068606621305435,10800,1346,0.12462962962962963,102691,6552,0.06380305966443019
2009-03-17,11968,1404,0.11731283422459893,155383,8230,0.05296589717021811,11387,1382,0.1213664705365768,106642,6865,0.06437426154798297,543,31,0.0570902394106814,2464,114,0.04626623376623377,543,31,0.0570902394106814,1587,112,0.07057340894770006,11425,1373,0.12017505470459519,152919,8116,0.05307384955433923,10844,1351,0.12458502397639247,105055,6753,0.06428061491599639
2009-04-16,12497,1420,0.11362727054493078,164668,8761,0.053204022639492796,11806,1394,0.11807555480264273,112102,7231,0.0645037555083763,539,29,0.05380333951762523,2680,129,0.04813432835820895,539,29,0.05380333951762523,1616,118,0.07301980198019802,11958,1391,0.1163237999665496,161988,8632,0.053287897868977946,11267,1365,0.12115026182657318,110486,7113,0.06437919736437196
2009-05-16,12612,1433,0.11362194735172851,167419,8922,0.053291442428876054,11866,1403,0.11823697960559582,112747,7351,0.06519907403301196,539,29,0.05380333951762523,3037,128,0.0421468554494567,539,29,0.05380333951762523,1616,118,0.07301980198019802,12073,1404,0.11629255363207157,164382,8794,0.053497341558078136,11327,1374,0.12130308113357464,111131,7233,0.0650853497223997
2009-06-15,12642,1433,0.11335231767125455,168571,8923,0.05293318542335277,11896,1403,0.11793880295897781,112925,7329,0.0649014832853664,539,29,0.05380333951762523,3034,128,0.04218852999340804,539,29,0.05380333951762523,1613,118,0.0731556106633602,12103,1404,0.11600429645542427,165537,8795,0.053130115925744695,11357,1374,0.12098265386986,111312,7211,0.06478187437113699
2009-07-15,12642,1433,0.11335231767125455,169837,8945,0.05266814651695449,11896,1403,0.11793880295897781,113879,7347,0.06451584576612018,539,29,0.05380333951762523,3222,128,0.03972687771570453,539,29,0.05380333951762523,1619,118,0.07288449660284126,12103,1404,0.11600429645542427,166615,8817,0.052918404705458694,11357,1374,0.12098265386986,112260,7229,0.0643951541065384
2009-08-17,12642,1433,0.11335231767125455,171452,9002,0.052504491052889436,11896,1403,0.11793880295897781,115163,7389,0.06416123234024818,539,29,0.05380333951762523,4079,193,0.04731551850943859,539,29,0.05380333951762523,2404,177,0.07362728785357738,12103,1404,0.11600429645542427,167373,8809,0.05263095003375694,11357,1374,0.12098265386986,112759,7212,0.06395941787351786
2009-09-16,12642,1432,0.11327321626324949,171734,9030,0.05258131761910862,11896,1402,0.11785474108944183,115369,7417,0.06428936716102246,539,29,0.05380333951762523,4089,194,0.04744436292492052,539,29,0.05380333951762523,2404,178,0.0740432612312812,12103,1403,0.11592167231264976,167645,8836,0.05270661218646545,11357,1373,0.12089460244782953,112965,7239,0.06408179524631523
2009-10-17,12703,1422,0.11194206093048886,172033,9039,0.052542244801869406,11957,1392,0.11641716149535837,115451,7424,0.06430433690483409,539,29,0.05380333951762523,7451,449,0.06026036773587438,539,29,0.05380333951762523,3948,425,0.10764944275582573,12164,1393,0.11451825057546859,164582,8590,0.05219282789126393,11418,1363,0.11937291995095463,111503,6999,0.06276961157995749
2009-11-16,13207,1448,0.10963882789429848,175009,9143,0.05224302750144278,12410,1418,0.11426269137792103,117022,7496,0.06405633128813386,539,29,0.05380333951762523,7488,449,0.05996260683760684,539,29,0.05380333951762523,3974,425,0.10694514343231001,12668,1419,0.11201452478686454,167521,8694,0.05189797100065067,11871,1389,0.1170078342178418,113048,7071,0.06254865190007784
2009-12-16,13230,1445,0.1092214663643235,179498,9345,0.05206186141349765,12433,1415,0.11381002171639991,119970,7628,0.06358256230724348,539,29,0.05380333951762523,6867,460,0.06698703946410368,539,29,0.05380333951762523,3986,425,0.10662318113396889,12691,1416,0.11157513198329524,172631,8885,0.05146816041151357,11894,1386,0.11652934252564318,115984,7203,0.06210339357152711
2010-01-16,14211,1567,0.11026669481387658,191229,9537,0.04987214282352572,13082,1535,0.11733679865463996,127513,7798,0.0611545489479504,560,62,0.11071428571428571,7097,404,0.056925461462589824,560,62,0.11071428571428571,4051,371,0.091582325351765,13651,1505,0.11024833345542451,184132,9133,0.0496002867508092,12522,1473,0.11763296597987542,123462,7427,0.0601561614099885
2010-02-15,14468,1591,0.1099668233342549,201082,11124,0.05532071493221671,13165,1557,0.11826813520698823,135434,9229,0.06814389296631569,560,62,0.11071428571428571,7133,404,0.05663816066171316,560,62,0.11071428571428571,4066,371,0.0912444663059518,13908,1529,0.10993672706356054,193949,10720,0.055272262295758164,12605,1495,0.11860372867909559,131368,8858,0.06742890201571158
2010-03-18,14640,1584,0.10819672131147541,205061,11335,0.0552762348764514,13263,1549,0.11679107290959813,136693,9328,0.06824050975543737,542,59,0.1088560885608856,7334,407,0.05549495500409054,542,59,0.1088560885608856,4074,370,0.09081983308787432,14098,1525,0.1081713718257909,197727,10928,0.055268122208904195,12721,1490,0.11712915651285276,132619,8958,0.06754688242257896
2010-04-19,14718,1588,0.10789509444217964,214460,11023,0.05139886225869626,13340,1553,0.1164167916041979,144287,8978,0.06222320791200871,542,59,0.1088560885608856,7370,410,0.05563093622795115,542,59,0.1088560885608856,4086,373,0.09128732256485561,14176,1529,0.10785835214446952,207090,10613,0.0512482495533343,12798,1494,0.11673699015471167,140201,8605,0.06137616707441459
2010-05-19,12220,1176,0.09623567921440263,216822,10999,0.05072824713359345,10747,1142,0.10626221271052387,146039,8988,0.06154520367846945,549,62,0.11293260473588343,7469,407,0.054491899852724596,549,62,0.11293260473588343,4087,371,0.09077563004648886,11671,1114,0.09545026133150544,209353,10592,0.050593972859237744,10198,1080,0.10590311825848206,141952,8617,0.06070361812443643
2010-06-19,12220,1176,0.09623567921440263,216979,11005,0.050719194023384755,10747,1142,0.10626221271052387,146107,8991,0.061537092678653316,549,62,0.11293260473588343,7473,408,0.05459654757125652,549,62,0.11293260473588343,4091,372,0.09093131263749694,11671,1114,0.09545026133150544,209506,10597,0.05058089028476511,10198,1080,0.10590311825848206,142016,8619,0.06069034474988734
2010-07-20,12220,1176,0.09623567921440263,217151,11009,0.05069744095122749,10747,1142,0.10626221271052387,146195,8990,0.0614932111221314,549,62,0.11293260473588343,7473,408,0.05459654757125652,549,62,0.11293260473588343,4091,372,0.09093131263749694,11671,1114,0.09545026133150544,209678,10601,0.05055847537652973,10198,1080,0.10590311825848206,142104,8618,0.0606457242582897
2010-08-19,12230,1178,0.09632052330335242,218719,11054,0.05053973363082311,10751,1142,0.10622267696028276,146396,9022,0.06162736686794721,549,62,0.11293260473588343,7538,410,0.0543910851684797,549,62,0.11293260473588343,4091,372,0.09093131263749694,11681,1116,0.09553976543104187,211181,10644,0.05040226156709174,10202,1080,0.10586159576553617,142305,8650,0.06078493376901725
2010-09-19,12272,1179,0.09607235984354628,221975,11120,0.05009573150129519,10776,1142,0.10597624350408315,147306,9051,0.06144352572196652,549,62,0.11293260473588343,9473,567,0.059854322812203105,549,62,0.11293260473588343,5619,526,0.09361096280476953,11723,1117,0.09528277744604624,212502,10553,0.04966070907567929,10227,1080,0.10560281607509533,141687,8525,0.06016783473430872
2010-10-19,16048,1534,0.09558823529411764,231823,11351,0.04896408035440832,11540,1304,0.11299826689774697,152467,9237,0.06058360169741649,553,62,0.11211573236889692,9545,565,0.05919329491880566,553,62,0.11211573236889692,5645,522,0.0924712134632418,15495,1472,0.09499838657631494,222278,10786,0.0485248202701122,10987,1242,0.11304268681168654,146822,8715,0.05935758946206972
2010-11-18,16100,1542,0.09577639751552795,238321,11550,0.04846404639121185,11491,1311,0.11408928726829692,156135,9375,0.06004419252569891,587,68,0.11584327086882454,9615,560,0.058242329693187725,587,68,0.11584327086882454,5706,517,0.09060637924991237,15513,1474,0.09501708244697996,228706,10990,0.048052958820494436,10904,1243,0.11399486426999267,150429,8858,0.05888492245511171
2010-12-18,16314,1553,0.09519431163417923,243505,11697,0.04803597462064434,11636,1319,0.11335510484702647,159601,9472,0.059347999072687514,590,69,0.11694915254237288,9988,559,0.05596716059271125,590,69,0.11694915254237288,5823,509,0.08741198694830843,15724,1484,0.0943780208598321,233517,11138,0.04769674156485395,11046,1250,0.11316313597682419,153778,8963,0.05828532039693584
2011-01-17,16385,1562,0.0953310955141898,246708,11817,0.04789873048300015,11693,1327,0.11348670144530916,160936,9492,0.058979967191927225,715,69,0.0965034965034965,12447,818,0.06571864706354945,715,69,0.0965034965034965,7425,762,0.10262626262626262,15670,1493,0.09527760051052968,234261,10999,0.04695190407280768,10978,1258,0.11459282200765167,153511,8730,0.05686888887441291
2011-02-16,16562,1583,0.09558024393189228,250226,12023,0.04804856409805536,11807,1345,0.11391547387143221,162636,9645,0.05930421308935291,912,91,0.09978070175438597,14420,918,0.0636615811373093,912,91,0.09978070175438597,8312,841,0.10117901828681425,15650,1492,0.09533546325878595,235806,11105,0.047093797443661316,10895,1254,0.1150986691142726,154324,8804,0.05704880640729893
2011-03-18,16716,1596,0.09547738693467336,252816,12048,0.047655211695462316,11937,1358,0.11376392728491246,163636,9642,0.05892346427436505,988,92,0.0931174089068826,14783,917,0.06203071095176892,988,92,0.0931174089068826,8334,841,0.10091192704583633,15728,1504,0.09562563580874874,238033,11131,0.04676242369755454,10949,1266,0.11562699789935153,155302,8801,0.05667022961713307
2011-04-17,16543,1593,0.09629450522879768,251635,11914,0.047346354839350645,11732,1351,0.11515513126491647,162621,9529,0.05859636824272388,938,93,0.09914712153518124,14286,901,0.0630687386252275,938,93,0.09914712153518124,8019,827,0.10313006609302905,15605,1500,0.09612303748798462,237349,11013,0.046400026964512175,10794,1258,0.11654622938669632,154602,8702,0.05628646459942303
2011-05-17,16688,1604,0.0961169702780441,256550,12064,0.04702397193529526,11762,1354,0.11511647678966162,164944,9605,0.058231884760888544,941,93,0.09883103081827843,14741,915,0.06207177260701445,941,93,0.09883103081827843,8254,833,0.10092076568936273,15747,1511,0.09595478503842002,241809,11149,0.04610663788361889,10821,1261,0.11653266796044728,156690,8772,0.055983151445529386
2011-06-16,17900,1684,0.0940782122905028,263843,12293,0.04659210212133731,12456,1421,0.1140815671162492,168507,9750,0.05786109775855009,960,93,0.096875,14670,934,0.06366734832992502,960,93,0.096875,7906,842,0.10650139134834304,16940,1591,0.09391971664698938,249173,11359,0.04558680113816505,11496,1328,0.11551844119693806,160601,8908,0.055466653383229245
2011-07-17,18131,1705,0.09403783575092384,265262,12312,0.04641448831721091,12627,1442,0.11419973073572504,169552,9758,0.05755166556572615,963,95,0.09865005192107996,14783,933,0.06311303524318473,963,95,0.09865005192107996,7899,837,0.10596278009874667,17168,1610,0.09377912395153774,250479,11379,0.045428958116249266,11664,1347,0.1154835390946502,161653,8921,0.055186108516390046
2011-08-17,17859,1684,0.09429419340388599,267938,12480,0.04657793967261083,12355,1423,0.1151760420882234,171075,9897,0.05785181937746602,963,95,0.09865005192107996,14837,939,0.06328772662937251,963,95,0.09865005192107996,7907,847,0.10712027317566714,16896,1589,0.09404592803030302,253101,11541,0.04559839747768677,11392,1328,0.11657303370786516,163168,9050,0.05546430672680918
2011-09-16,17503,1701,0.09718333999885734,271707,12856,0.047315674605365336,12034,1449,0.12040884161542297,173263,10045,0.05797544772975188,963,95,0.09865005192107996,23186,1229,0.05300612438540499,963,95,0.09865005192107996,15542,1125,0.07238450649852014,16540,1606,0.09709794437726724,248521,11627,0.04678477875109146,11071,1354,0.12230150844548822,157721,8920,0.05655556330482307
2011-10-16,17606,1702,0.096671589230944,276670,13064,0.04721870820833484,12060,1444,0.11973466003316749,174918,10099,0.05773562469271316,963,95,0.09865005192107996,23022,1209,0.052514985665884806,963,95,0.09865005192107996,15653,1121,0.07161566472880598,16643,1607,0.09655711109775882,253648,11855,0.04673799911688639,11097,1349,0.12156438677119942,159265,8978,0.05637145637773522
2011-11-15,17661,1714,0.09704999716890324,278196,13038,0.04686623819177846,12102,1456,0.12031069244752933,175620,10099,0.05750483999544471,994,106,0.10663983903420524,23185,1194,0.05149881388828984,994,106,0.10663983903420524,15758,1106,0.07018657189998731,16667,1608,0.09647807043859123,255011,11844,0.04644505531133951,11108,1350,0.12153402952826792,159862,8993,0.0562547697388998
2011-12-15,18362,1751,0.0953599825727045,281106,13182,0.04689334272480843,12701,1493,0.1175497992284072,176944,10131,0.05725540283931639,996,106,0.10642570281124498,23349,1183,0.050665981412480195,996,106,0.10642570281124498,15833,1092,0.06896987304995894,17366,1645,0.09472532534838189,257757,11999,0.04655159704683093,11705,1387,0.11849636907304571,161111,9039,0.05610417662357008
2012-01-14,18930,1801,0.09513998943475964,286065,13256,0.04633911873175677,13004,1541,0.11850199938480467,179700,10139,0.056421814134668895,996,106,0.10642570281124498,23734,1200,0.05056037751748546,996,106,0.10642570281124498,15999,1099,0.06869179323707732,17934,1695,0.09451321512211441,262331,12056,0.045957206735002726,12008,1435,0.11950366422385077,163701,9040,0.05522263150499997
2012-02-13,19471,1846,0.09480766267782857,289524,13186,0.045543720037026295,13158,1548,0.11764705882352941,181613,10199,0.056157874160990676,1011,107,0.10583580613254204,23922,1204,0.050330239946492765,1011,107,0.10583580613254204,16045,1102,0.0686818323465254,18460,1739,0.09420368364030336,265602,11982,0.04511261210382452,12147,1441,0.11863011443154689,165568,9097,0.05494419211441825
2012-03-14,19527,1847,0.0945869821273109,292514,13247,0.04528672131932147,13191,1547,0.11727693124099765,183036,10219,0.055830546996219324,1017,108,0.10619469026548672,24218,1201,0.04959121314724585,1017,108,0.10619469026548672,16155,1097,0.06790467347570411,18510,1739,0.09394921663965423,268296,12046,0.044898172168053196,12174,1439,0.11820272712337769,166881,9122,0.05466170504730916
2012-04-13,19440,1826,0.09393004115226337,291625,13219,0.04532876125160737,13102,1527,0.11654709204701573,182115,10197,0.05599209290832716,994,104,0.10462776659959759,23871,1163,0.048720204432156175,994,104,0.10462776659959759,15953,1074,0.0673227606092898,18446,1722,0.09335357259026347,267754,12056,0.04502640483428819,12108,1423,0.11752560290716882,166162,9123,0.05490425006920956
2012-05-14,18324,1643,0.08966382885832788,288720,13026,0.04511637572734829,11956,1340,0.11207761793241887,179372,10023,0.05587828646611511,990,102,0.10303030303030303,23943,1178,0.049200183769786576,990,102,0.10303030303030303,15964,1084,0.06790278125783011,17334,1541,0.08890042690665743,264777,11848,0.044747089059850365,10966,1238,0.11289440087543316,163408,8939,0.05470356408498972
2012-06-13,18509,1651,0.08919984872224324,291644,13063,0.04479090946496413,12119,1348,0.11123029952966416,181374,10053,0.055426907936087864,994,102,0.10261569416498995,23930,1175,0.04910154617634768,994,102,0.10261569416498995,15933,1081,0.06784660766961652,17515,1549,0.08843848130174137,267714,11888,0.04440559701771293,11125,1246,0.112,165441,8972,0.05423081340175652
2012-07-13,18646,1659,0.08897350638206586,292153,13096,0.04482582756295503,12226,1352,0.11058400130868641,181582,10076,0.05549008161601921,994,102,0.10261569416498995,23945,1175,0.04907078722071414,994,102,0.10261569416498995,15943,1081,0.0678040519350185,17652,1557,0.08820530251529572,268208,11921,0.04444684722305077,11232,1250,0.11128917378917379,165639,8995,0.054304843666044836
2012-08-12,19165,1718,0.08964257761544482,294318,13178,0.04477469947471782,12713,1407,0.11067411311256195,182536,10105,0.055358942893456636,1065,107,0.10046948356807511,24498,1185,0.04837129561596865,1065,107,0.10046948356807511,16042,1085,0.06763495823463408,18100,1611,0.08900552486187845,269820,11993,0.04444815061893114,11648,1300,0.11160714285714286,166494,9020,0.05417612646701983
2012-09-11,19480,1743,0.08947638603696098,296793,13245,0.04462706330674915,12913,1423,0.11019902423913885,184222,10134,0.055009716537655656,1093,109,0.09972552607502287,24745,1203,0.0486158819963629,1093,109,0.09972552607502287,16207,1098,0.06774850373295489,18387,1634,0.08886713438842661,272048,12042,0.04426424748573781,11820,1314,0.11116751269035532,168015,9036,0.05378091241853406
2012-10-11,19764,1741,0.08808945557579437,300290,13363,0.04450031636085118,12962,1417,0.10931954945224502,186028,10189,0.05477132474681231,1092,109,0.09981684981684982,24816,1204,0.04851708575112831,1092,109,0.09981684981684982,16225,1100,0.06779661016949153,18672,1632,0.08740359897172237,275474,12159,0.04413846678815424,11870,1308,0.11019376579612468,169803,9089,0.053526733921073245
2012-11-10,19883,1743,0.08766282754111553,297010,13427,0.04520723207972795,13016,1417,0.1088660110633067,187079,10250,0.05478968777895969,1083,103,0.0951061865189289,25494,1168,0.04581470149839178,1083,103,0.0951061865189289,15929,1034,0.0649130516667713,18800,1640,0.08723404255319149,271516,12259,0.04515019372707318,11933,1314,0.11011480767619207,171150,9216,0.05384750219106047
2012-12-10,19955,1749,0.08764720621398146,300220,13478,0.04489374458730264,13075,1423,0.10883365200764818,189109,10283,0.0543760476762079,1097,103,0.09389243391066546,25670,1169,0.045539540319439034,1097,103,0.09389243391066546,15959,1035,0.06485368757440943,18858,1646,0.08728391133736345,274550,12309,0.04483336368603169,11978,1320,0.11020203706795792,173150,9248,0.05341033785734912
2013-01-09,19811,1723,0.0869718843066983,291232,12868,0.044184704977475,12913,1398,0.10826299078448076,179394,9626,0.05365842781809871,1097,103,0.09389243391066546,25774,1164,0.04516179095212229,1097,103,0.09389243391066546,15898,1031,0.06485092464460938,18714,1620,0.08656620711766592,265458,11704,0.044089837187050306,11816,1295,0.10959715639810426,163496,8595,0.052570093457943924
2013-02-08,20009,1749,0.08741066520065971,293044,12875,0.04393538171742128,13024,1415,0.1086455773955774,180208,9583,0.05317743940335612,1126,110,0.09769094138543517,26356,1193,0.045264835331613296,1126,110,0.09769094138543517,16369,1057,0.06457327875862912,18883,1639,0.08679764867870571,266688,11682,0.04380399568034557,11898,1305,0.10968229954614221,163839,8526,0.05203889183893945
2013-03-10,20471,1793,0.08758731864588931,301259,13939,0.04626915710402013,13344,1449,0.10858812949640288,186233,10581,0.05681592413804213,1150,114,0.09913043478260869,30786,1355,0.04401351263561359,1150,114,0.09913043478260869,18946,1156,0.06101551778739576,19321,1679,0.08690026396149268,270473,12584,0.04652590092171862,12194,1335,0.10948007216663933,167287,9425,0.056340301398195916
2013-04-10,22051,1815,0.0823091923268786,304991,13984,0.04585053329442508,13423,1462,0.10891752961335022,187946,10563,0.05620231343045343,1150,114,0.09913043478260869,31149,1362,0.04372532023499952,1150,114,0.09913043478260869,19119,1157,0.06051571734923375,20901,1701,0.08138366585330846,273842,12622,0.04609227218615114,12273,1348,0.10983459626823108,168827,9406,0.055713837241673426
2013-05-10,22091,1834,0.08302023448463175,305733,14035,0.04590606836684297,13429,1480,0.11020924864100082,188396,10595,0.05623792437206735,1150,114,0.09913043478260869,31230,1367,0.04377201408901697,1150,114,0.09913043478260869,19183,1162,0.06057446697596831,20941,1720,0.08213552361396304,274503,12668,0.04614885811812621,12279,1366,0.1112468442055542,169213,9433,0.05574630790778486
2013-06-09,22501,1866,0.08292964757121905,310810,14272,0.04591872848363952,13690,1504,0.10986121256391526,190977,10650,0.05576587756640852,1172,114,0.09726962457337884,31881,1351,0.04237633700323076,1172,114,0.09726962457337884,19424,1150,0.05920510708401977,21329,1752,0.08214168502977168,278929,12921,0.04632361640417454,12518,1390,0.11104010225275603,171553,9500,0.05537647257698787
2013-07-09,19767,1678,0.08488895634137704,314000,14394,0.04584076433121019,13625,1494,0.10965137614678899,192703,10753,0.05580089567884257,1167,109,0.0934018851756641,32527,1375,0.042272573554277985,1167,109,0.0934018851756641,19871,1170,0.058879774545820544,18600,1569,0.08435483870967742,281473,13019,0.04625310420537671,12458,1385,0.11117354310483224,172832,9583,0.0554469079800037
2013-08-08,19867,1681,0.08461267428398853,316830,14469,0.045668023861376764,13699,1495,0.10913205343455727,193783,10819,0.05583049080672711,1167,109,0.0934018851756641,33042,1418,0.04291507777979541,1167,109,0.0934018851756641,20121,1200,0.059639182943193675,18700,1572,0.08406417112299465,283788,13051,0.04598855483670909,12532,1386,0.11059687200766039,173662,9619,0.05538920431643077
2013-09-07,20128,1623,0.08063394276629571,326417,15240,0.04668874476513172,13916,1448,0.10405288876113826,199471,11476,0.05753217259651779,1160,106,0.09137931034482759,36517,1541,0.04219952350959827,1160,106,0.09137931034482759,20595,1239,0.06016023306627822,18968,1517,0.07997680303669338,289900,13699,0.04725422559503277,12756,1342,0.10520539354029476,178876,10237,0.057229589212638925
2013-10-07,20425,1652,0.0808812729498164,331186,15445,0.046635425410494404,14127,1460,0.10334819848517024,202050,11545,0.057139321950012374,1163,106,0.09114359415305245,38759,1604,0.04138393663407209,1163,106,0.09114359415305245,22244,1285,0.057768386980758854,19262,1546,0.0802616550721628,292427,13841,0.04733147076022392,12964,1354,0.10444307312557853,179806,10260,0.05706149961625307
2013-11-06,21114,1686,0.07985223074737141,337320,15569,0.04615498636309735,14715,1489,0.10118926265715257,204956,11619,0.05669021643669861,1248,109,0.08733974358974358,39463,1612,0.0408483896307934,1248,109,0.08733974358974358,22643,1287,0.05683875811509076,19866,1577,0.07938185845162589,297857,13957,0.04685805604702928,13467,1380,0.10247271107150813,182313,10332,0.05667176778397591
2013-12-06,21376,1722,0.08055763473053892,340370,15659,0.04600581719893058,14930,1526,0.10221031480241126,206173,11668,0.056593249358548404,1267,110,0.08681925808997633,39571,1608,0.04063581916049632,1267,110,0.08681925808997633,22569,1278,0.056626345872657184,20109,1612,0.08016311104480581,300799,14051,0.04671225635723523,13663,1416,0.10363756129693333,183604,10390,0.05658918106359338
2014-01-05,21393,1719,0.08035338662179217,342831,15801,0.04608976434453127,14884,1522,0.10225745767266864,207816,11791,0.056737691034376564,1265,110,0.08695652173913043,39840,1612,0.040461847389558235,1265,110,0.08695652173913043,22825,1278,0.05599123767798467,20128,1609,0.07993839427662958,302991,14189,0.04682977382166467,13619,1412,0.10367868419120346,184991,10513,0.05682979171959717
2014-02-04,21492,1728,0.08040201005025126,351275,16121,0.04589281901644011,14946,1526,0.10210089656095277,212691,12072,0.056758395982904775,1265,110,0.08695652173913043,40589,1684,0.04148907339426938,1265,110,0.08695652173913043,23664,1350,0.05704868154158215,20227,1618,0.0799920897809858,310686,14437,0.046468138248907255,13681,1416,0.10350120605218917,189027,10722,0.05672205557936168
2014-03-06,21680,1728,0.07970479704797048,355550,16266,0.04574883982562228,15039,1521,0.10113704368641532,215255,12174,0.056556177556851175,1254,93,0.07416267942583732,41428,1699,0.041010910495317174,1254,93,0.07416267942583732,24265,1362,0.05613022872450031,20426,1635,0.08004504063448546,314122,14567,0.04637370193746379,13785,1428,0.10359085963003264,190990,10812,0.05661029373265616
2014-04-05,21416,1698,0.07928651475532313,347895,15827,0.04549361157820607,14894,1494,0.10030884920102054,211944,12060,0.05690182312308912,1257,93,0.07398568019093078,41594,1703,0.040943405298841176,1257,93,0.07398568019093078,24293,1376,0.05664183098011773,20159,1605,0.07961704449625477,306301,14124,0.04611150469636077,13637,1401,0.10273520569040112,187651,10684,0.05693548129239919
2014-05-05,21505,1683,0.0782608695652174,350516,15877,0.045296077782469274,14921,1473,0.09871992493800684,213412,12108,0.05673532884748749,1245,77,0.061847389558232935,51152,1919,0.0375156396621833,1245,77,0.061847389558232935,29958,1505,0.05023699846451699,20260,1606,0.0792694965449161,299364,13958,0.04662551275370452,13676,1396,0.10207663059374086,183454,10603,0.057796504845901424
2014-06-04,21650,1699,0.0784757505773672,355031,16052,0.04521295323506962,14900,1474,0.0989261744966443,215402,12172,0.0565082961160992,1445,100,0.06920415224913495,51679,1925,0.03724917277811103,1298,91,0.07010785824345146,30452,1511,0.049619072638907136,20205,1599,0.0791388270230141,303352,14127,0.04656966164719534,13602,1383,0.10167622408469343,184950,10661,0.057642606109759395
2014-07-04,21432,1702,0.0794139604329974,361454,16390,0.04534463583194542,14668,1477,0.10069539132806109,217944,12356,0.05669346254083618,1460,115,0.07876712328767123,52198,1940,0.03716617494923177,1313,106,0.08073115003808073,30714,1522,0.04955394933906362,19972,1587,0.07946124574404166,309256,14450,0.04672504332979797,13355,1371,0.10265818045675777,187230,10834,0.05786465844148908
2014-08-03,21626,1717,0.07939517247757329,363293,16471,0.04533806046359275,14814,1489,0.1005130282165519,218659,12398,0.05670015869458838,1464,115,0.07855191256830601,52601,1962,0.03729967110891428,1317,106,0.08048595292331055,30983,1537,0.0496078494658361,20162,1602,0.07945640313460967,310692,14509,0.04669898162810758,13497,1383,0.10246721493665259,187676,10861,0.0578710117436433
2014-09-02,21795,1732,0.07946776783665978,367524,16850,0.04584734602366104,14896,1499,0.10063104189044039,220915,12760,0.05775977185795442,1470,114,0.07755102040816327,54222,1996,0.036811626277156874,1317,105,0.07972665148063782,31920,1554,0.04868421052631579,20325,1618,0.07960639606396064,313302,14854,0.04741112409113252,13579,1394,0.10265851682745415,188995,11206,0.05929257387761581
2014-10-02,22025,1732,0.07863791146424517,371968,16982,0.04565446490020647,14979,1496,0.09987315575138528,223237,12856,0.05758901974135112,1502,113,0.07523302263648468,54952,2009,0.03655917891978454,1317,104,0.07896735003796507,32528,1566,0.048143138219380224,20523,1619,0.07888710227549578,317016,14973,0.04723105458399576,13662,1392,0.10188844971453667,190709,11290,0.059200142625675765
2014-11-01,22280,1746,0.07836624775583483,368398,17090,0.046390045548564324,15067,1502,0.0996880599986726,217927,12930,0.05933179459176697,1539,113,0.07342430149447693,55136,2013,0.03650972141613465,1354,104,0.07680945347119646,32645,1572,0.04815438811456579,20741,1633,0.07873294440962345,313262,15077,0.04812904214363695,13713,1398,0.10194705753664406,185282,11358,0.06130115175786099
2014-12-01,22427,1757,0.07834306862264236,370991,17219,0.04641352485639813,15200,1510,0.0993421052631579,218917,12964,0.059218790683226975,1555,113,0.07266881028938907,55508,2021,0.036409166246306836,1370,104,0.07591240875912408,32893,1582,0.048095339433922114,20872,1644,0.07876581065542354,315483,15198,0.04817375262692443,13830,1406,0.10166305133767173,186024,11382,0.06118565346406915
2014-12-31,23109,1780,0.07702626682245013,381290,17619,0.04620892234257389,15424,1533,0.0993905601659751,221830,13177,0.0594013433710499,1555,113,0.07266881028938907,58603,2265,0.038649898469361635,1370,104,0.07591240875912408,34658,1824,0.05262854175082232,21554,1667,0.07734063282917324,322687,15354,0.047581712309451574,14054,1429,0.10167923722783549,187172,11353,0.06065543991622679
2015-01-30,21643,1583,0.07314143140969366,385396,17582,0.04562060841316464,14307,1346,0.09407982106661075,222221,12991,0.05845982152901841,1548,113,0.07299741602067183,59508,2269,0.038129327149290855,1362,104,0.0763582966226138,35158,1817,0.05168098299106889,20095,1470,0.07315252550385667,325888,15313,0.04698853593872741,12945,1242,0.09594438006952491,187063,11174,0.05973388644467372
2015-03-01,21777,1592,0.07310465169674427,386998,17666,0.045648814722556705,14285,1342,0.09394469723486175,222262,13000,0.05848953037406304,1561,113,0.0723894939141576,59216,2269,0.038317346663064036,1370,104,0.07591240875912408,35064,1826,0.05207620351357518,20216,1479,0.0731598733676296,327782,15397,0.046973293225375405,12915,1238,0.09585753000387147,187198,11174,0.05969080866248571
2015-03-31,21942,1610,0.07337526205450734,390747,17702,0.045302970976104744,14338,1352,0.0942948807365044,224442,12957,0.0577298366615874,2561,252,0.09839906286606795,66521,2345,0.035252025676102285,2118,221,0.10434372049102927,39357,1843,0.0468277561806032,19381,1358,0.07006862391001496,324226,15357,0.0473651095223702,12220,1131,0.0925531914893617,185085,11114,0.06004808601453386
2015-04-30,22041,1613,0.07318179755909442,394858,17827,0.04514787594527653,14360,1352,0.09415041782729805,226337,13029,0.05756460499167171,2568,252,0.09813084112149532,66788,2312,0.034616997065341076,2125,221,0.104,39594,1813,0.045789766126180735,19473,1361,0.06989164484157552,328070,15515,0.047291736519645196,12235,1131,0.09243972210870453,186743,11216,0.060061153563989014
2015-05-30,22061,1617,0.07329676805221885,398290,17836,0.04478144065881644,14372,1356,0.09435012524352908,227888,13005,0.05706750684546795,2568,252,0.09813084112149532,67101,2311,0.03444061936483808,2125,221,0.104,39780,1808,0.045449974861739566,19493,1365,0.07002513722874878,331189,15525,0.046876556890476435,12247,1135,0.09267575732832531,188108,11197,0.05952431581857231
2015-06-29,22320,1666,0.0746415770609319,404278,17926,0.0443407754070219,14529,1402,0.09649666184871636,230876,13017,0.05638091443025693,2554,250,0.09788566953797964,68257,2366,0.03466311147574608,2111,219,0.10374230222643296,40253,1838,0.04566119295456239,19766,1416,0.07163816654861883,336021,15560,0.04630662964517099,12418,1183,0.09526493799323563,190623,11179,0.058644549713308465
2015-07-29,22377,1670,0.07463020065245565,412650,18493,0.04481521870834848,14552,1403,0.09641286421110501,232678,13113,0.05635685367761456,2554,250,0.09788566953797964,69008,2378,0.03445977277996754,2111,219,0.10374230222643296,40696,1850,0.0454590131708276,19823,1420,0.07163396055087524,343642,16115,0.04689473347262558,12441,1184,0.09516919861747448,191982,11263,0.058666958360679644
2015-08-28,22642,1712,0.07561169507993994,416245,18555,0.04457711203738183,14705,1439,0.09785787147228833,234712,13157,0.05605593237669996,2553,250,0.09792401096748923,70603,2441,0.03457360168831353,2110,219,0.1037914691943128,42144,1911,0.045344533029612756,20089,1462,0.07277614614963412,345642,16114,0.04662049172264945,12595,1220,0.09686383485510124,192568,11246,0.058400149557558886
2015-09-27,22770,1699,0.0746157224418094,418508,18222,0.04354038632475365,14709,1422,0.09667550479298388,232563,12823,0.05513774762107472,2499,251,0.10044017607042817,70557,2440,0.03458196918803237,2086,222,0.10642377756471716,41532,1909,0.045964557449677354,20271,1448,0.07143209511124267,347951,15782,0.04535696118131576,12623,1200,0.09506456468351422,191031,10914,0.057132088509194844
2015-10-27,22911,1720,0.0750731089869495,418819,18278,0.04364176410334775,14737,1433,0.09723824387595847,232610,12859,0.05528137225398736,2508,252,0.10047846889952153,70634,2456,0.034770790270974315,2095,223,0.10644391408114559,41538,1924,0.04631903317444268,20403,1468,0.07195020340146056,348185,15822,0.04544136019644729,12642,1210,0.09571270368612561,191072,10935,0.05722973538770725
2015-11-26,23007,1756,0.07632459686182466,420574,18374,0.04368791223423226,14806,1458,0.09847359178711333,233427,12872,0.055143578077943,2764,285,0.10311143270622286,72521,2515,0.03467961004398726,2351,256,0.10888983411314335,41737,1943,0.04655341783070178,20243,1471,0.07266709479820185,348053,15859,0.04556489959862435,12455,1202,0.0965074267362505,191690,10929,0.05701392873911002
2015-12-26,23169,1764,0.07613621649618024,422476,18498,0.0437847357009629,14914,1465,0.09822985114657369,234136,12943,0.05527983735948338,2783,287,0.10312612288896873,72691,2522,0.03469480403351172,2363,258,0.10918324164198054,41836,1950,0.046610574624725114,20386,1477,0.07245168252722456,349785,15976,0.04567377103077605,12551,1207,0.09616763604493665,192300,10993,0.057165886635465415
2016-01-25,23662,1796,0.0759022905925112,423471,18538,0.04377631526125756,15062,1484,0.0985260921524366,234524,12977,0.055333356074431614,2811,292,0.10387762362148702,72446,2400,0.03312812301576346,2389,263,0.11008790288823776,41316,1818,0.04400232355503921,20851,1504,0.07213083305357057,351025,16138,0.04597393348052133,12673,1221,0.0963465635603251,193208,11159,0.057756407602169685
2016-02-24,23847,1831,0.07678114647544765,424989,19230,0.04524822995418705,15127,1492,0.0986315859059959,235409,13027,0.05533773135266706,2845,301,0.10579964850615114,73548,2645,0.035962908576711805,2418,267,0.11042183622828784,42241,1828,0.04327549063705878,21002,1530,0.07285020474240549,351441,16585,0.04719142046602417,12709,1225,0.09638838618301991,193168,11199,0.05797544106684337
2016-03-25,23915,1833,0.07664645619903826,427394,19307,0.0451737740819946,15166,1493,0.0984438876434129,236701,13066,0.055200442752671094,2901,301,0.10375732506032402,73696,2656,0.03603994789405124,2450,266,0.10857142857142857,43062,1856,0.043100645580790485,21014,1532,0.07290377843342534,353698,16651,0.04707688480002714,12716,1227,0.09649260773828248,193639,11210,0.05789123058887931
2016-04-24,23879,1826,0.07646886385527032,431369,19481,0.04516087155080685,15092,1484,0.09833024118738404,238784,13170,0.05515444920932726,2905,302,0.10395869191049914,72029,2463,0.034194560524233295,2462,267,0.10844841592201462,43200,1849,0.04280092592592592,20974,1524,0.07266139029274339,359340,17018,0.047359047141982524,12630,1217,0.09635787806809185,195584,11321,0.057883057918848166
2016-05-24,23832,1845,0.07741691842900301,438071,19958,0.045558824939336315,15104,1506,0.09970868644067797,241136,13300,0.05515559684161635,2937,307,0.104528430371127,72150,2463,0.034137214137214135,2494,272,0.1090617481956696,43123,1842,0.04271502446490272,20895,1538,0.0736061258674324,365921,17495,0.047810866279880085,12610,1234,0.0978588421887391,198013,11458,0.057864887658891084
2016-06-23,24057,1870,0.07773205304069501,447226,20991,0.04693600103750677,15205,1528,0.10049325879644853,244124,13520,0.05538169127164883,2937,316,0.10759278175008512,72418,2472,0.03413515976690878,2494,281,0.11267040898155574,43241,1839,0.042529081196087046,21120,1554,0.07357954545454545,374808,18519,0.0494092975603509,12711,1247,0.09810400440563291,200883,11681,0.05814827536426676
2016-07-24,24126,1877,0.0777998839426345,449890,21030,0.04674475983018071,15226,1532,0.10061736503349533,245500,13566,0.05525865580448065,2937,316,0.10759278175008512,74223,2666,0.035918785282190155,2494,281,0.11267040898155574,45025,2040,0.045308162132148805,21189,1561,0.07367030062768418,375667,18364,0.04888371882544913,12732,1251,0.09825636192271442,200475,11526,0.0574934530490086
2016-08-23,24393,1910,0.07830115196982741,452598,20979,0.04635239218909496,15269,1528,0.10007204139105377,246463,13578,0.05509143360260972,2733,257,0.09403585803146725,74543,2672,0.03584508270394269,2272,220,0.09683098591549295,45161,2042,0.045216004960031884,21660,1653,0.07631578947368421,378055,18307,0.04842417108621761,12997,1308,0.1006386089097484,201302,11536,0.05730693187350349
2016-09-22,24653,1885,0.07646128260252302,454032,21076,0.0464196356203968,15412,1490,0.09667791331430055,246537,13558,0.05499377375404098,2767,238,0.08601373328514637,74997,2683,0.03577476432390629,2289,199,0.08693752730449979,45280,2047,0.045207597173144876,21886,1647,0.07525358676779677,379035,18393,0.048525861727808775,13123,1291,0.09837689552693744,201257,11511,0.0571955261183462
2016-10-22,24863,1879,0.0755741463218437,454917,21067,0.046309546576628266,15472,1482,0.09578593588417787,246940,13552,0.054879727869118,2775,237,0.08540540540540541,75666,2725,0.036013533158882456,2297,198,0.08619939050936004,45923,2089,0.04548918842410121,22088,1642,0.07433900760593988,379251,18342,0.04836374854647713,13175,1284,0.0974573055028463,201017,11463,0.05702502773397275
2016-11-21,24737,1853,0.0749080325019202,455562,21028,0.04615837141816043,15400,1481,0.09616883116883117,247502,13543,0.054718749747476786,2783,237,0.0851598993891484,76157,2745,0.03604396181572278,2305,198,0.0859002169197397,46481,2111,0.045416406703814464,21954,1616,0.07360845404026602,379405,18283,0.048188611114771816,13095,1283,0.09797632684230623,201021,11432,0.05686968028215957
2016-12-21,24766,1869,0.07546636517806671,452078,20230,0.04474891501024159,15390,1496,0.09720597790773229,248173,13585,0.05474004021388306,2791,255,0.09136510211393765,76486,2737,0.03578432654341971,2313,216,0.0933852140077821,46607,2105,0.04516488939429699,21975,1614,0.07344709897610921,375592,17493,0.046574474429700315,13077,1280,0.09788177716601668,201566,11480,0.05695404979014318
2017-01-20,23760,1761,0.07411616161616162,442275,19866,0.044917754790571474,14561,1403,0.09635327244007967,243353,13374,0.05495720208914622,2660,237,0.08909774436090226,75176,2666,0.035463445780568266,2225,208,0.09348314606741573,45998,2039,0.04432801426148963,21100,1524,0.07222748815165876,367099,17200,0.04685384596525733,12336,1195,0.09687094682230869,197355,11335,0.05743457221757746
2017-02-20,23335,1697,0.07272337690164989,442498,19862,0.04488607858114613,14155,1337,0.09445425644648534,243089,13346,0.054901702668569946,2639,246,0.09321712769988633,75046,2654,0.035364976147962586,2196,207,0.0942622950819672,45810,2023,0.04416066361056538,20696,1451,0.07011016621569385,367452,17208,0.04683060644655628,11959,1130,0.0944895058115227,197279,11323,0.05739587082254067
2017-03-22,23386,1700,0.07269306422646027,441680,19750,0.04471563122622713,14161,1340,0.09462608572840901,241814,13260,0.054835534749849056,2636,246,0.09332321699544764,75118,2647,0.03523789238265129,2192,207,0.09443430656934307,45788,2014,0.043985323665589236,20750,1454,0.0700722891566265,366562,17103,0.0466578641539494,11969,1133,0.0946612081209792,196026,11246,0.057369940722149106
2017-04-21,23440,1699,0.07248293515358362,442525,19691,0.044496921077905205,14210,1339,0.09422941590429275,241984,13185,0.05448707352552235,2690,245,0.09107806691449814,74529,2578,0.03459056206308954,2243,206,0.09184128399465002,45126,1941,0.04301289722111421,20750,1454,0.0700722891566265,367996,17113,0.046503222861118056,11967,1133,0.09467702849502799,196858,11244,0.05711731298702618
2017-05-21,23416,1698,0.07251451998633412,443380,19684,0.04439532680770445,14178,1326,0.09352517985611511,242265,13173,0.05437434214599715,2695,245,0.09090909090909091,74672,2578,0.03452431969145061,2246,206,0.0917186108637578,45208,1941,0.04293487878251637,20721,1453,0.07012209835432653,368708,17106,0.04639443679008863,11932,1120,0.09386523633925578,197057,11232,0.05699873640621749
2017-06-20,23496,1702,0.07243786176370447,446202,19940,0.044688280195965054,14212,1329,0.09351252462707571,243559,13249,0.0543974971156886,2697,246,0.09121245828698554,74701,2632,0.03523379874432739,2248,207,0.09208185053380782,45362,1945,0.04287729817909263,20799,1456,0.0700033655464205,371501,17308,0.04658937661002258,11964,1122,0.09378134403209629,198197,11304,0.057034162979258014
2017-07-20,23571,1705,0.07233464850876077,447332,19943,0.044582100095678374,14198,1318,0.09282997605296521,244049,13253,0.05430466832480363,2685,243,0.09050279329608939,74883,2625,0.035054685309082165,2236,204,0.09123434704830054,45440,1958,0.043089788732394364,20886,1462,0.06999904242076031,372449,17318,0.04649764128780048,11962,1114,0.09312823942484534,198609,11295,0.056870534567919885
2017-08-19,23618,1713,0.07252942670844272,448819,19952,0.044454446001617576,14201,1321,0.0930216181959017,244831,13264,0.05417614599458402,2685,243,0.09050279329608939,74920,2612,0.03486385477843033,2236,204,0.09123434704830054,45538,1958,0.04299705740260881,20933,1470,0.07022404815363302,373899,17340,0.04637616040695482,11965,1117,0.09335562055996657,199293,11306,0.056730542467623046
2017-09-18,23834,1730,0.07258538222707057,461131,20875,0.04526913176516001,14224,1335,0.093855455568054,254898,14101,0.055320167282599315,2693,251,0.09320460453026365,75370,2625,0.03482818097386228,2244,212,0.0944741532976827,45803,1969,0.04298845053817436,21141,1479,0.06995884773662552,385761,18250,0.047309085158945566,11980,1123,0.09373956594323873,209095,12132,0.05802147349290992
2017-10-18,23844,1737,0.07284851534977353,461020,20826,0.04517374517374517,14195,1343,0.09461077844311377,254623,14021,0.05506572462032102,2734,268,0.0980248719824433,75085,2583,0.03440101218618898,2245,226,0.10066815144766147,45498,1929,0.042397468020572336,21110,1469,0.06958787304594978,385935,18243,0.047269617940844964,11950,1117,0.09347280334728034,209125,12092,0.057821876867901974
2017-11-17,23902,1736,0.0726299054472429,461738,20846,0.04514681486037536,14207,1342,0.09446047722953474,254853,14023,0.055023876509203345,2733,268,0.09806073911452616,75197,2587,0.034402968203518756,2244,226,0.10071301247771836,45562,1930,0.04235986128791537,21169,1468,0.06934668619207332,386541,18259,0.04723690371784623,11963,1116,0.09328763688038118,209291,12093,0.05778079324959028
2017-12-18,23911,1743,0.0728953201455397,462387,20942,0.04529106570902729,14217,1348,0.09481606527396778,254977,14036,0.055048102377861535,2732,268,0.09809663250366032,75185,2596,0.034528163862472566,2243,226,0.10075791350869372,45550,1939,0.04256860592755214,21179,1475,0.06964445913404788,387202,18346,0.0473809536107768,11974,1122,0.0937030232169701,209427,12097,0.05776237065898857
2018-01-17,23890,1738,0.07275010464629553,463732,21008,0.045302027895422356,14169,1341,0.09464323523184416,255485,14102,0.055196978296181774,2739,266,0.09711573566995253,75222,2603,0.03460423812182606,2248,224,0.099644128113879,45615,1944,0.04261756001315357,21151,1472,0.06959481821190487,388510,18405,0.04737329798460786,11921,1117,0.09370019293683415,209870,12158,0.05793110020488874
2018-02-16,23857,1724,0.07226390577189085,466865,21103,0.045201503646664455,14099,1323,0.0938364423008724,257440,14152,0.054972032318210066,2796,270,0.09656652360515021,76665,2649,0.03455292506358834,2268,224,0.09876543209876543,45849,1968,0.04292350978211084,21061,1454,0.06903755757086558,390200,18454,0.04729369554074833,11831,1099,0.09289155608148085,211591,12184,0.057582789438114096
2018-03-18,23918,1745,0.07295760515093236,468171,21134,0.045141625602611014,14141,1342,0.09490135068241284,258012,14155,0.05486178937413764,3504,341,0.09731735159817352,76575,2671,0.03488083578191316,2720,285,0.10477941176470588,45939,1977,0.04303532945862992,20414,1404,0.06877632996962868,391596,18463,0.04714808118571181,11421,1057,0.09254881358900272,212073,12178,0.05742362299774134
2018-04-17,23924,1746,0.07298110683832135,469578,21203,0.0451533078636563,14143,1343,0.09495863678144666,258487,14195,0.05491572110009401,3504,341,0.09731735159817352,76704,2684,0.03499165623696287,2720,285,0.10477941176470588,46005,1988,0.0432126942723617,20420,1405,0.0688050930460333,392874,18519,0.04713725011072252,11423,1058,0.09262015232425808,212482,12207,0.05744957219905686
2018-05-17,23977,1743,0.07269466572131626,470994,21357,0.04534452668186856,14184,1344,0.09475465313028765,259083,14297,0.05518308804514383,3490,337,0.09656160458452723,77050,2687,0.034873458792991564,2706,281,0.10384331116038432,46117,2011,0.04360647917253941,20487,1406,0.06862888661102162,393944,18670,0.04739252279511809,11478,1063,0.09261195330196899,212966,12286,0.0576899598997023
2018-06-16,23999,1747,0.07279469977915747,471613,21410,0.04539739150532322,14183,1344,0.09476133399139815,259245,14322,0.05524503847711624,3491,338,0.09682039530220567,77121,2688,0.03485431983506438,2707,282,0.1041743627632065,46139,2012,0.043607360367584905,20508,1409,0.06870489565047787,394492,18722,0.047458503594496215,11476,1062,0.09254095503659812,213106,12310,0.057764680487644646
2018-07-16,24130,1745,0.07231661831744716,475171,21606,0.04546994660869456,14246,1340,0.09406149094482662,260774,14406,0.05524323743931527,3494,338,0.09673726388093876,77132,2689,0.03486231395529741,2706,282,0.10421286031042129,46235,2005,0.043365415810533145,20636,1407,0.06818181818181818,398039,18917,0.04752549373302616,11540,1058,0.09168110918544194,214539,12401,0.05780301017530612
2018-08-15,24185,1752,0.07244159603059748,476783,21723,0.045561607691549405,14256,1342,0.0941358024691358,261274,14459,0.05534037064537612,3512,340,0.09681093394077449,78972,2819,0.035696196120143846,2710,282,0.10405904059040591,47119,2119,0.04497124302298436,20673,1412,0.06830164949450974,397811,18904,0.047520053492739016,11546,1060,0.09180668629828512,214155,12340,0.05762181597441106
2018-09-14,24283,1764,0.07264341308734505,477634,21737,0.045509741768802056,14280,1348,0.09439775910364145,261471,14451,0.05526807944284452,3511,340,0.0968385075477072,79131,2829,0.035750843537930774,2709,282,0.10409745293466224,47228,2126,0.045015668671127294,20772,1424,0.06855382245330252,398503,18908,0.04744757254023182,11571,1066,0.09212686889637887,214243,12325,0.05752813394136565
2018-10-14,24290,1756,0.07229312474269246,478642,21822,0.04559148591222668,14266,1340,0.09392962287957381,261817,14483,0.055317263584870345,3494,343,0.0981682884945621,79273,2815,0.035510198932801836,2692,285,0.10586924219910847,47319,2126,0.04492909824806103,20796,1413,0.06794575879976919,399369,19007,0.04759257729067604,11574,1055,0.0911525833765336,214498,12357,0.057608928754580464
2018-11-13,24413,1770,0.07250235530250276,480210,21950,0.04570916890527061,14275,1342,0.09401050788091068,262434,14546,0.05542726933247979,3499,343,0.09802800800228637,79404,2824,0.0355649589441338,2691,285,0.10590858416945373,47408,2129,0.044908032399595,20914,1427,0.06823180644544324,400806,19126,0.04771884652425363,11584,1057,0.09124654696132596,215026,12417,0.05774650507380503
2018-12-15,24531,1769,0.07211283681871918,481190,22008,0.045736611317774685,14339,1343,0.09366064579119883,262729,14580,0.055494444846210356,3501,343,0.09797200799771494,79628,2836,0.03561561259858341,2693,285,0.1058299294467137,47428,2134,0.04499451800624104,21030,1426,0.06780789348549691,401562,19172,0.047743561392761265,11646,1058,0.09084664262407693,215301,12446,0.0578074416746787
2019-01-14,25455,1819,0.07145943822431743,483163,22163,0.045870648207747694,14648,1351,0.09223102129983615,263437,14673,0.055698326355067815,3531,348,0.09855564995751911,80273,2876,0.03582773784460529,2704,287,0.10613905325443787,47684,2160,0.04529821323714454,21924,1471,0.06709542054369641,402890,19287,0.047871627491374816,11944,1064,0.08908238446081715,215753,12513,0.05799687605734335
2019-02-13,24653,1784,0.07236441812355494,483415,22110,0.045737099593516954,13778,1317,0.09558716794890405,263508,14644,0.05557326532780788,3721,380,0.10212308519215264,80615,2908,0.036072691186503754,2782,315,0.11322789360172537,47787,2178,0.04557724904262665,20932,1404,0.06707433594496465,402800,19202,0.047671300893743794,10996,1002,0.09112404510731174,215721,12466,0.057787605286457974
2019-03-15,24720,1789,0.07237055016181229,484335,22216,0.04586907822065306,13812,1321,0.09564147118447727,263781,14702,0.055735629177234146,3716,380,0.10226049515608181,80602,2911,0.036115729138234784,2777,315,0.11343176089305006,47804,2180,0.04560287842021588,21004,1409,0.06708246048371738,403733,19305,0.047816254802059775,11035,1006,0.09116447666515633,215977,12522,0.057978395847706005
2019-04-14,24731,1791,0.07241923092475032,485778,22326,0.04595926534342848,13824,1323,0.095703125,264159,14710,0.05568615871501634,3724,382,0.10257787325456498,80854,2911,0.03600316620080639,2785,317,0.11382405745062836,47973,2180,0.0454422279198716,21007,1409,0.0670728804684153,404924,19415,0.047947269117167665,11039,1006,0.09113144306549506,216186,12530,0.057959349819137224
2019-05-14,24758,1798,0.07262299054850957,487163,22416,0.04601334666220546,13823,1325,0.09585473486218621,264676,14767,0.05579274282519004,3727,383,0.10276361685001341,80967,2918,0.0360393740659775,2776,317,0.11419308357348704,48085,2187,0.04548195903088281,21031,1415,0.06728163187675336,406196,19498,0.048001457424494576,11047,1008,0.09124649226034218,216591,12580,0.05808182242106089
2019-06-13,24825,1812,0.07299093655589124,488174,22494,0.04607783290384166,13819,1328,0.09609957305159562,265102,14792,0.0557973911928239,3742,383,0.10235168359166222,91667,4746,0.05177435718415569,2781,317,0.11398777418194894,58633,4009,0.06837446489178449,21083,1429,0.06777972774273111,396507,17748,0.04476087433513153,11038,1011,0.09159267983330313,206469,10783,0.05222575786195506
2019-07-13,24938,1821,0.07302109230892613,490460,22629,0.046138319128980955,13908,1335,0.0959879206212252,266311,14887,0.0559008077022729,3748,382,0.10192102454642477,92462,4806,0.05197810992623997,2788,316,0.1133428981348637,58802,4014,0.06826298425223631,21190,1439,0.06790939122227466,397998,17823,0.04478163206850286,11120,1019,0.09163669064748202,207509,10873,0.05239772732748941
2019-08-12,24932,1831,0.0734397561366918,492245,22705,0.04612540503204705,13916,1335,0.09593273929290026,267179,14930,0.055880140280486115,3948,395,0.10005065856129686,93971,4849,0.05160102584840004,2792,315,0.11282234957020057,59372,4043,0.0680960722225965,20984,1436,0.06843309187952726,398274,17856,0.04483345636421157,11124,1020,0.09169363538295577,207807,10887,0.05238995798986559
2019-09-11,24867,1838,0.07391321832147023,494666,22833,0.04615841800325877,13894,1340,0.0964445084209011,268419,15041,0.05603552654618339,3993,398,0.09967443025294265,94510,4889,0.051729975663950906,2806,312,0.11119030648610122,59837,4083,0.06823537276267193,20874,1440,0.06898534061511928,400156,17944,0.04484251142054599,11088,1028,0.09271284271284272,208582,10958,0.052535693396362104
2019-10-11,24924,1849,0.07418552399293853,496099,22906,0.046172235783583516,13932,1349,0.0968274476026414,269007,15079,0.056054303419613614,4016,400,0.099601593625498,94777,4906,0.05176361353492936,2810,312,0.1110320284697509,59984,4085,0.06810149373166177,20908,1449,0.06930361584082648,401322,18000,0.044851764916949484,11122,1037,0.09323862614637655,209023,10994,0.05259708261770236
2019-11-11,25116,1858,0.07397674788979137,497806,23019,0.04624090509154168,13964,1351,0.09674878258378689,269481,15114,0.056085586738953766,4026,400,0.09935419771485346,94870,4901,0.05166016654369137,2817,312,0.11075612353567625,59989,4077,0.06796245978429379,21090,1458,0.06913229018492176,402936,18118,0.04496495721404888,11147,1039,0.09320893513949942,209492,11037,0.05268458938766158
2019-12-11,25139,1853,0.07371017144675604,499923,23120,0.04624712205679675,13974,1344,0.09617861743237441,270428,15145,0.056003816172881506,4025,400,0.09937888198757763,96829,4931,0.050924826240072704,2816,312,0.11079545454545454,60389,4084,0.06762821043567536,21114,1453,0.0688168987401724,403094,18189,0.04512346995986048,11158,1032,0.0924896934934576,210039,11061,0.05266164855098339
2020-01-10,25148,1853,0.07368379195164626,501482,23179,0.04622100095317479,13974,1344,0.09617861743237441,270980,15166,0.05596723005387851,4026,400,0.09935419771485346,97798,4969,0.05080880999611444,2816,312,0.11079545454545454,60839,4106,0.06748960370814773,21122,1453,0.06879083420130669,403684,18210,0.04510954112622745,11158,1032,0.0924896934934576,210141,11060,0.052631328488966934
2020-02-10,25198,1857,0.07369632510516708,502720,23269,0.04628620305537874,13984,1344,0.09610983981693363,271556,15199,0.055970039328904535,4026,400,0.09935419771485346,98056,4976,0.050746512197111855,2816,312,0.11079545454545454,61019,4109,0.06733968108294137,21172,1457,0.06881730587568487,404664,18293,0.04520540497795702,11168,1032,0.09240687679083094,210537,11090,0.05267482675254231
2020-03-11,25362,1881,0.07416607523066004,504429,23300,0.046190841525764775,14093,1364,0.09678563826012915,272109,15180,0.05578646792278094,4118,421,0.10223409422049538,98313,4981,0.05066471372046423,2888,331,0.11461218836565097,61090,4113,0.06732689474545753,21244,1460,0.06872528713989833,406116,18319,0.04510780171182618,11205,1033,0.09219098616688978,211019,11067,0.0524455143849606
2020-04-10,25518,1902,0.0745356219139431,502377,22908,0.04559922130193062,14238,1381,0.09699395982581824,273322,15284,0.055919391779659156,4118,421,0.10223409422049538,98648,5028,0.05096910226259022,2888,331,0.11461218836565097,61292,4148,0.06767604255041441,21400,1481,0.06920560747663551,403729,17880,0.044287133200736135,11350,1050,0.09251101321585903,212030,11136,0.05252086968825166
2020-05-11,25543,1903,0.07450182045961712,508357,23288,0.045810326207763444,14250,1382,0.09698245614035088,277757,15501,0.05580777442152673,4120,421,0.10218446601941747,98639,5054,0.05123734020012368,2888,331,0.11461218836565097,61692,4167,0.06754522466446217,21423,1482,0.06917798627643187,409718,18234,0.0445037806491294,11362,1051,0.09250132019010737,216065,11334,0.05245643672043135
2020-06-10,25667,1907,0.07429773639303386,510774,23379,0.04577171116775717,14246,1383,0.0970798820721606,278405,15544,0.05583233059751082,4133,426,0.10307282845390757,98820,5053,0.05113337381096944,2889,331,0.11457251644167532,61735,4171,0.06756297076212846,21534,1481,0.06877496052753784,411954,18326,0.04448554935745253,11357,1052,0.09263009597605001,216670,11373,0.05248996169289703
2020-07-10,25755,1906,0.07400504756357988,513643,23571,0.045889849564775535,14266,1382,0.09687368568624702,279261,15642,0.056012117696348576,4133,426,0.10307282845390757,99206,5063,0.051035219643973145,2889,331,0.11457251644167532,61877,4172,0.06742408326195518,21622,1480,0.06844880214596244,414437,18508,0.04465817482512421,11377,1051,0.09237936187044037,217384,11470,0.05276377286276819
2020-08-10,25897,1919,0.07410124724871607,516153,23667,0.045852683216023156,14282,1385,0.09697521355552444,280183,15674,0.05594200932961672,4133,426,0.10307282845390757,99341,5063,0.050965865050684005,2889,331,0.11457251644167532,61983,4173,0.06732491166932869,21764,1493,0.06859952214666422,416812,18604,0.04463403164976056,11393,1054,0.09251294654612481,218200,11501,0.05270852428964253
2020-09-09,26040,1929,0.07407834101382489,517671,23736,0.045851515731033805,14305,1388,0.09702901083537224,280670,15695,0.055919763423237255,4215,435,0.10320284697508897,99581,5080,0.051013747602454286,2905,334,0.11497418244406196,62084,4183,0.06737645770246763,21825,1494,0.06845360824742268,418090,18656,0.044621971345882465,11400,1054,0.0924561403508772,218586,11512,0.052665769994418674
2020-10-09,26088,1928,0.07390371051824594,519622,23822,0.04584486415124841,14347,1392,0.0970237680351293,281263,15749,0.055993856283976205,4234,438,0.10344827586206896,100107,5092,0.050865573835995485,2924,337,0.11525307797537619,62306,4191,0.06726478990787405,21854,1490,0.06817973826301821,419515,18730,0.044646794512711106,11423,1055,0.09235752429309288,218957,11558,0.05278662020396699
2020-11-09,26270,1939,0.07381043014845831,521602,23917,0.04585296835518269,14369,1394,0.09701440601294453,282147,15783,0.055938925453752834,4234,438,0.10344827586206896,100469,5092,0.050682300012939316,2924,337,0.11525307797537619,62403,4190,0.06714420781052192,22036,1501,0.06811581049192231,421133,18825,0.044700842726644555,11445,1057,0.09235474006116208,219744,11593,0.052756844327945245
2020-12-09,26388,1943,0.07363195391844778,522746,23991,0.045894181878005764,14422,1393,0.09658854527804743,282436,15816,0.05599852709994477,4234,438,0.10344827586206896,100518,5096,0.05069738753258123,2924,337,0.11525307797537619,62397,4193,0.06719874352933634,22154,1505,0.06793355601697211,422228,18895,0.044750703411427,11498,1056,0.09184205948860671,220039,11623,0.052822454201300675
2021-01-09,26423,1942,0.07349657495363887,524221,24105,0.045982515007983275,14430,1391,0.0963963963963964,283142,15849,0.05597544694888077,4234,438,0.10344827586206896,100680,5117,0.05082439411998411,2924,337,0.11525307797537619,62445,4194,0.06716310353110737,22189,1504,0.067781333092974,423541,18988,0.04483155113672584,11506,1054,0.09160438032330957,220697,11655,0.052809961168479864
2021-02-08,26195,1963,0.0749379652605459,525954,24260,0.04612570681086178,14183,1393,0.09821617429316788,283907,15896,0.05599016579372823,4079,430,0.10541799460652121,100677,5110,0.05075637931205737,2825,333,0.11787610619469027,62211,4185,0.06727106138785745,22116,1533,0.0693163320672816,425277,19150,0.04502947490694301,11358,1060,0.09332628983976052,221696,11711,0.05282458862586605
2021-03-10,26200,1925,0.07347328244274809,527869,24399,0.04622169515542682,14123,1383,0.09792536996388869,284429,15944,0.05605616867478351,3942,411,0.10426179604261795,100833,5113,0.05070760564497734,2753,320,0.11623683254631312,62261,4184,0.06720097653426704,22258,1514,0.0680204870159044,427036,19286,0.04516246873799867,11370,1063,0.09349164467897977,222168,11760,0.052932915631414064
2021-04-09,26306,1929,0.07332927849159887,529876,24503,0.046242894564011205,14148,1385,0.0978936952219395,285075,15997,0.05611505744102429,3946,412,0.10440952863659402,101266,5141,0.05076728615724922,2757,321,0.11643090315560392,62402,4208,0.06743373609820198,22360,1517,0.0678443649373882,428610,19362,0.04517393434590887,11391,1064,0.09340707576156615,222673,11789,0.05294310491168664
2021-05-11,26356,1946,0.07383517984519654,531172,24581,0.04627691218663634,14180,1399,0.09866008462623413,285647,16041,0.056156724908716,3961,414,0.1045190608432214,101503,5154,0.050776824330315364,2764,321,0.11613603473227208,62452,4209,0.06739575994363671,22395,1532,0.06840812681402099,429669,19427,0.045213873935517804,11416,1078,0.09442887175893483,223195,11832,0.053011940231636016
2021-06-10,26483,1946,0.07348110108371408,533240,24668,0.04626059560423074,14237,1394,0.0979138863524619,286418,16072,0.05611379173096663,4015,406,0.10112079701120796,101909,5182,0.05084928710908752,2804,313,0.11162624821683309,62553,4226,0.06755871021373874,22468,1540,0.06854192629517536,431331,19486,0.04517644222186673,11433,1081,0.0945508615411528,223865,11846,0.05291581980211288
2021-07-12,26519,1949,0.0734944756589615,535380,24789,0.046301692255967725,14242,1394,0.09787951130459205,287285,16099,0.05603842873801278,4015,406,0.10112079701120796,102093,5198,0.05091436239507116,2800,313,0.11178571428571428,62604,4228,0.06753562072711009,22504,1543,0.0685655883398507,433287,19591,0.045214834509228294,11442,1081,0.09447649012410418,224681,11871,0.052834908158678306
2021-08-11,26583,1963,0.0738441861339954,537601,24831,0.04618853015526385,14228,1392,0.09783525442788867,288020,16061,0.05576348864662176,4012,405,0.10094715852442672,102874,5193,0.05047922701557245,2797,312,0.11154808723632463,62887,4191,0.06664334441140458,22571,1558,0.0690266270878561,434727,19638,0.04517317764942136,11431,1080,0.09447992301635902,225133,11870,0.05272438958304647
2021-09-10,26639,1973,0.07406434175457037,539696,24897,0.046131525896060004,14247,1397,0.09805573103109426,288411,16086,0.05577457170496271,4022,408,0.10144206862257583,103319,5203,0.05035859812812745,2807,315,0.11221945137157108,62926,4194,0.06664971553888695,22617,1565,0.0691957377194146,436377,19694,0.045130701205608914,11440,1082,0.09458041958041959,225485,11892,0.05273965008758898
2021-10-11,26794,1988,0.07419571545868478,541891,25040,0.04620855485697308,14357,1411,0.09827958487149126,289579,16129,0.05569809965501642,4033,409,0.10141333994545004,103703,5216,0.050297484161499664,2819,317,0.11245122383824051,63082,4191,0.06643733553153039,22761,1579,0.06937305039321646,438188,19824,0.04524085552320009,11538,1094,0.09481712601837407,226497,11938,0.052707099873287505
2021-11-10,26855,1972,0.07343139080245764,543883,25156,0.04625259476762465,14400,1393,0.0967361111111111,290105,16207,0.055865979559125145,4058,391,0.09635288319369148,103739,5216,0.05028002968989483,2844,299,0.10513361462728552,63092,4191,0.06642680530019654,22797,1581,0.06935123042505593,440144,19940,0.045303355265549454,11556,1094,0.09466943579093112,227013,12016,0.052930889420429665
2021-12-10,27210,1980,0.07276736493936053,545274,25167,0.04615477723126355,14417,1399,0.09703821876950822,290574,16190,0.05571730436997116,4067,393,0.09663142365379887,104039,5197,0.04995242168802084,2847,301,0.1057253249034071,63158,4164,0.0659298901168498,23143,1587,0.06857365077993345,441235,19970,0.04525932892902875,11570,1098,0.09490060501296456,227416,12026,0.05288106377739473
2022-01-10,27463,1993,0.0725703674034155,547196,25247,0.04613886066418614,14415,1396,0.09684356573014222,291411,16256,0.05578375558918503,4058,389,0.09586002957121735,104218,5209,0.049981768984244564,2824,293,0.10375354107648725,63227,4173,0.06600028468850333,23405,1604,0.0685323648792993,442978,20038,0.04523475206443661,11591,1103,0.09516003796048658,228184,12083,0.05295288013182344
2022-02-09,29622,1943,0.06559314023361015,593765,24419,0.041125697877106265,15442,1341,0.08684108276130036,302992,15715,0.0518660558694619,4544,356,0.07834507042253522,111577,4927,0.04415784615108848,3062,260,0.08491182233834095,65163,3936,0.06040237558123475,25078,1587,0.06328255841773667,482188,19492,0.04042406696143413,12380,1081,0.08731825525040388,237829,11779,0.04952718129412309
2022-03-11,29675,1943,0.0654759898904802,595523,24464,0.04107985753698849,15498,1345,0.08678539166344044,303640,15697,0.051696087472006325,4554,355,0.07795344751866491,111744,4932,0.04413659793814433,3072,259,0.08430989583333333,65230,3937,0.06035566457151617,25121,1588,0.06321404402690976,483779,19532,0.04037380704825964,12426,1086,0.08739739256397876,238410,11760,0.04932678998364162
2022-04-11,29956,1960,0.06542929630124182,597890,24678,0.0412751509474987,15509,1357,0.08749758204913276,304785,15854,0.052016995587053166,4553,355,0.07797056885569954,111722,4942,0.044234797085623244,3071,259,0.08433734939759036,65035,3946,0.06067502114246175,25403,1605,0.0631815139944101,486168,19736,0.04059502065129749,12438,1098,0.08827785817655572,239750,11908,0.04966840458811262
2022-05-11,30088,1972,0.06554107950013294,601073,24906,0.04143589880097758,15592,1365,0.08754489481785531,306161,15998,0.052253552869242,4623,357,0.07722258273848151,112400,4945,0.043994661921708186,3104,259,0.08344072164948453,65319,3942,0.060349974739356084,25465,1615,0.06342038091498135,488673,19961,0.04084735600288946,12488,1106,0.08856502242152467,240842,12056,0.05005771418606389
2022-06-13,30186,1971,0.06529516994633273,603162,24940,0.041348758708274064,15655,1364,0.08712871287128712,306878,16025,0.05221944877117291,4624,357,0.07720588235294118,112446,4949,0.044012236984863846,3105,259,0.08341384863123993,65311,3942,0.06035736705914777,25562,1614,0.0631405993271262,490716,19991,0.040738431190342275,12550,1105,0.08804780876494024,241567,12083,0.05001924931799459
2022-07-13,30327,1977,0.06518943515679097,604333,24981,0.04133648170793255,15746,1368,0.08687920741775688,307317,16035,0.05217739337556985,4703,360,0.07654688496704232,112347,4933,0.04390860459113283,3134,260,0.08296107211231653,65227,3928,0.06022046085210112,25624,1617,0.06310490165469872,491986,20048,0.04074912700767908,12612,1108,0.08785283856644466,242090,12107,0.05001032673799
2022-08-12,30296,1973,0.06512410879324003,605267,25060,0.04140321544045851,15690,1358,0.08655194391332059,307875,16090,0.052261469752334554,4698,360,0.07662835249042145,112588,4936,0.04384126194621096,3129,260,0.08309364014062001,65330,3931,0.06017143731823052,25598,1613,0.06301273536995078,492679,20124,0.040846068129552916,12561,1098,0.08741342249820874,242545,12159,0.050130903543672306
2022-09-12,30322,1970,0.06496932919992085,606760,25136,0.04142659371085767,15713,1353,0.0861070451218736,308273,16128,0.05231726424305729,4704,362,0.07695578231292517,113166,4960,0.043829418730007244,3131,262,0.08367933567550304,65374,3931,0.06013093890537523,25618,1608,0.0627683659926614,493594,20176,0.04087569946150075,12582,1091,0.08671117469400731,242899,12197,0.05021428659648661
2022-10-12,30344,1973,0.0650210914843132,607626,25165,0.041415278477221186,15717,1355,0.0862123814977413,308717,16151,0.05231652289961356,4704,362,0.07695578231292517,113246,4974,0.043922081133108457,3131,262,0.08367933567550304,65432,3940,0.060215185230468274,25640,1611,0.06283151326053042,494380,20191,0.04084105344067317,12586,1093,0.08684252343874146,243285,12211,0.0501921614567277
2022-11-11,30357,1979,0.06519089501597655,608953,25134,0.041274121319707764,15730,1361,0.08652256834075016,309230,16098,0.05205833845357824,4698,362,0.07705406555981269,113188,4962,0.04383856945966003,3125,262,0.08384,65222,3921,0.06011775167888136,25659,1617,0.06301882380451304,495765,20172,0.04068863271913104,12605,1099,0.08718762395874653,244008,12177,0.049904101504868695
2022-12-12,30439,1983,0.06514668681625546,610304,25262,0.04139248636744967,15790,1364,0.0863837872070931,309570,16176,0.052253125302839425,4746,364,0.07669616519174041,113442,4986,0.043951975458824774,3147,262,0.08325389259612329,65342,3933,0.060190995072082275,25693,1619,0.06301327209745845,496862,20276,0.04080811170908623,12643,1102,0.08716285691687099,244228,12243,0.05012938729384018
2023-01-11,30567,1991,0.06513560375568424,613316,25443,0.04148432455699835,15864,1370,0.08635905194150277,311193,16308,0.05240477774242994,4766,364,0.07637431808644565,113909,5007,0.04395614042788542,3167,262,0.08272813388064414,65654,3947,0.06011819538794285,25801,1627,0.0630595713344444,499407,20436,0.040920531750656276,12697,1108,0.08726470819878711,245539,12361,0.05034230814656735
2023-02-10,29415,1961,0.06666666666666667,613750,25220,0.04109164969450102,15331,1372,0.08949187919900854,312831,16215,0.05183309838219358,4715,392,0.08313891834570519,113723,4974,0.043737854259912244,3116,290,0.09306803594351733,65762,3938,0.05988260697667346,24700,1569,0.06352226720647773,500027,20246,0.040489813550068296,12215,1082,0.08857961522717969,247069,12277,0.049690572269285097
2023-03-12,29453,1962,0.06661460632193665,617709,25375,0.04107921367504764,15347,1372,0.08939857952694337,315409,16325,0.05175819332993034,4712,392,0.0831918505942275,114141,4991,0.043726618831094875,3113,290,0.09315772566655958,66096,3950,0.05976155894456548,24741,1570,0.0634574188593832,503568,20384,0.040479140850888065,12234,1082,0.08844204675494523,249313,12375,0.049636400829479406
2023-04-11,29517,1970,0.0667411999864485,618829,25418,0.04107435171913404,15379,1378,0.08960270498732037,315974,16348,0.051738434174963766,4712,392,0.0831918505942275,114240,4996,0.04373249299719888,3113,290,0.09315772566655958,66153,3955,0.059785648421084456,24805,1578,0.06361620640999799,504589,20422,0.04047254300034285,12266,1088,0.08870047285178542,249821,12393,0.04960751898359225
2023-05-11,29570,1978,0.06689212039228948,621722,26001,0.041820942479114456,15397,1382,0.08975774501526271,317813,16901,0.053179070711393175,4716,392,0.08312128922815945,114382,4998,0.04369568638422129,3117,290,0.0930381777350016,66189,3957,0.05978334768617142,24854,1586,0.06381266596926048,507340,21003,0.04139827334726219,12280,1092,0.08892508143322475,251624,12944,0.051441833847327756
2023-06-10,29605,1986,0.06708326296233744,623835,26062,0.04177707246307116,15415,1390,0.09017191047680831,318575,16909,0.053076983441889665,4735,393,0.08299894403379092,114656,5006,0.04366103823611499,3126,290,0.0927703134996801,66354,3963,0.059725110769508996,24870,1593,0.06405307599517492,509179,21056,0.04135284448101748,12289,1100,0.08951094474733501,252221,12946,0.051328002029965784
2023-07-10,29605,1987,0.0671170410403648,625928,26182,0.04182909216395496,15418,1394,0.09041380204955247,319182,16984,0.05321102067159176,4735,393,0.08299894403379092,114876,5022,0.043716703227828266,3126,290,0.0927703134996801,66494,3978,0.05982494661172437,24870,1594,0.06409328508242863,511052,21160,0.04140478855380666,12292,1104,0.08981451350471852,252688,13006,0.051470588235294115
2023-08-09,29591,1987,0.0671487952417965,627394,26219,0.041790326334010204,15440,1394,0.09028497409326425,319562,16991,0.05316965095975116,4739,393,0.08292888795104453,115026,5021,0.04365100064333281,3148,290,0.09212198221092757,66545,3977,0.05976406942670373,24852,1594,0.0641397070658297,512368,21198,0.0413726071885832,12292,1104,0.08981451350471852,253017,13014,0.051435279052395685
2023-09-08,30048,2016,0.0670926517571885,630068,26383,0.04187325812451989,15547,1414,0.09095002251238181,320382,17047,0.05320835752320667,4760,394,0.08277310924369748,115198,5019,0.043568464730290454,3150,290,0.09206349206349207,66662,3975,0.05962917404218295,25288,1622,0.06414109459031953,514870,21364,0.04149396935148678,12397,1124,0.09066709687827701,253720,13072,0.05152136213148353
2023-10-09,30173,2043,0.06770954164319093,628736,26255,0.041758385077361564,15598,1429,0.09161430952686242,319911,16956,0.053002241248347196,4792,400,0.08347245409015025,114590,4946,0.043162579631730515,3165,294,0.09289099526066351,66184,3910,0.05907772271243805,25381,1643,0.06473346203853277,514146,21309,0.04144542600739868,12433,1135,0.09128931070538084,253727,13046,0.051417468381370526
2023-11-08,30427,2065,0.06786735465211818,630788,26334,0.041747782139165614,15646,1440,0.0920363032084878,320829,16985,0.05294097478719193,4792,400,0.08347245409015025,114877,4964,0.043211434839001715,3165,294,0.09289099526066351,66338,3918,0.059061171575869036,25635,1665,0.0649502633118783,515911,21370,0.041421873152539875,12481,1146,0.09181956573992468,254491,13067,0.05134562715380898
2023-12-08,30466,2068,0.06787894702291078,632698,26423,0.041762420617735475,15659,1440,0.09195989526789705,321261,17002,0.052922701479482415,4788,402,0.08395989974937343,115360,4970,0.04308252427184466,3160,294,0.0930379746835443,66405,3919,0.059016640313229424,25678,1666,0.06488044240205623,517338,21453,0.04146805376755622,12499,1146,0.09168733498679894,254856,13083,0.051334871456822674
2024-01-07,30496,2071,0.06791054564533054,633742,26512,0.04183405865478381,15660,1440,0.09195402298850575,321668,17054,0.05301739681908054,4788,402,0.08395989974937343,115485,4983,0.04314846083907001,3160,294,0.0930379746835443,66442,3923,0.059043978206556096,25708,1669,0.06492142523728023,518257,21529,0.041541165869443154,12500,1146,0.09168,255226,13131,0.05144852013509595
2024-02-06,30637,2073,0.06766328295851422,635839,26601,0.04183606227362587,15683,1442,0.09194669387234586,322430,17091,0.05300685420091183,4888,402,0.08224222585924713,115661,4990,0.04314332402451993,3161,294,0.09300854160075925,66522,3928,0.05904813445176032,25749,1671,0.06489572410579052,520178,21611,0.041545394076643,12522,1148,0.09167864558377256,255908,13163,0.05143645372555762
2024-03-07,30750,2058,0.06692682926829269,638224,26705,0.0418426759256938,15705,1423,0.09060808659662528,323204,17150,0.05306246209824136,4939,378,0.07653371127758656,115997,5009,0.04318215126253265,3177,274,0.08624488511174064,66619,3943,0.05918731893303712,25811,1680,0.06508852814691411,522227,21696,0.04154515182095143,12528,1149,0.09171455938697318,256585,13207,0.05147222168092445
2024-04-10,30754,2058,0.06691812447161345,639991,26862,0.041972465237792404,15707,1423,0.09059654930922519,324052,17261,0.05326614247096145,4941,378,0.07650273224043716,117020,5101,0.043590839172790975,3179,274,0.08619062598301352,67164,4012,0.05973438151390626,25813,1680,0.06508348506566458,522971,21761,0.041610337858122154,12528,1149,0.09171455938697318,256888,13249,0.05157500544984585
2024-05-10,30773,2068,0.06720176778344653,640682,26888,0.0419677780864766,15726,1433,0.09112298105048963,324299,17270,0.05325332486378311,4941,378,0.07650273224043716,117053,5102,0.04358709302623598,3179,274,0.08619062598301352,67180,4013,0.0597350401905329,25832,1690,0.06542273149581913,523629,21786,0.04160579341480323,12547,1159,0.09237267872798278,257119,13257,0.05155978360214531
2024-06-09,30788,2072,0.06729894764193842,642578,26967,0.04196688962273841,15741,1437,0.09129026110158185,324716,17319,0.05333583808620456,4957,382,0.07706273956021788,117885,5141,0.04361029817194724,3195,278,0.08701095461658842,67301,4033,0.05992481538164366,25831,1690,0.06542526421741318,524693,21826,0.0415976580590936,12546,1159,0.0923800414474733,257415,13286,0.051613153856612866
2024-07-09,30986,2083,0.06722390757116117,644113,27033,0.041969343888417096,15921,1448,0.09094906098863137,325249,17332,0.053288403653816,5021,405,0.08066122286397132,117939,5139,0.04357337267570524,3252,301,0.09255842558425584,67299,4029,0.05986715998751839,25965,1678,0.06462545734642788,526174,21894,0.041609809682728524,12669,1147,0.09053595390322836,257950,13303,0.05157201007947276
2024-08-08,30994,2084,0.06723882041685487,645837,27127,0.04200285830635284,15914,1449,0.09105190398391354,326041,17398,0.053361387064817,5040,406,0.08055555555555556,118073,5150,0.04361708434612486,3256,302,0.09275184275184276,67321,4035,0.05993672108257453,25954,1678,0.06465284734530323,527764,21977,0.04164171864697099,12658,1147,0.09061463106335914,258720,13363,0.0516504329004329
2024-09-07,30494,2077,0.0681117596904309,647280,27148,0.04194166357681375,15711,1440,0.09165552797403094,326415,17397,0.05329718303386793,5073,406,0.08003153952296471,118300,5161,0.04362637362637363,3266,302,0.09246785058175137,67374,4037,0.05991925668655564,25421,1671,0.06573305534794067,528980,21987,0.041564898483874624,12445,1138,0.09144234632382484,259041,13360,0.051574847224956664
2024-10-07,30506,2076,0.06805218645512358,649856,27280,0.04197853062832382,15710,1440,0.0916613621896881,327548,17468,0.05332958833514477,5071,405,0.079865904160915,118744,5190,0.04370747153540389,3264,301,0.09221813725490197,67557,4059,0.060082596918158,25435,1671,0.06569687438568901,531112,22090,0.04159198059919565,12446,1139,0.09151534629599871,259991,13409,0.0515748622067687
2024-11-06,30527,2078,0.06807088806630196,651809,27361,0.041977020875747346,15731,1442,0.09166613692708664,328466,17493,0.05325665365669506,5071,405,0.079865904160915,119039,5187,0.04357395475432421,3264,301,0.09221813725490197,67727,4059,0.059931784960207894,25456,1673,0.06572124450031427,532770,22174,0.041620211348236576,12467,1141,0.09152161706906232,260739,13434,0.051522787154971064
2024-12-06,30570,2079,0.06800785083415113,657637,27722,0.042153954233110365,15744,1442,0.09159044715447154,329799,17562,0.053250616284464175,5084,406,0.07985837922895359,119418,5195,0.04350265454119145,3270,301,0.09204892966360856,67981,4060,0.05972256954148954,25486,1673,0.06564388291611081,538219,22527,0.04185470969995485,12474,1141,0.0914702581369248,261818,13502,0.05157017470151021
2025-01-06,30626,2079,0.06788349768170836,659652,27799,0.04214191725333964,15747,1442,0.09157299803137106,330420,17602,0.05327159372919315,5099,406,0.0796234555795254,119571,5212,0.043589164596766775,3272,301,0.09199266503667482,68030,4055,0.059606056151697784,25527,1673,0.06553844948485917,540081,22587,0.04182150455209496,12475,1141,0.0914629258517034,262390,13547,0.05162925416364953
2025-02-05,30571,2075,0.06787478329135455,660514,27765,0.04203544512304054,15722,1438,0.09146419030657676,330591,17584,0.05318959076320892,5119,403,0.078726313733151,119590,5166,0.043197591771887284,3261,298,0.09138301134621282,67887,4042,0.059540118137493186,25452,1672,0.0656922835140657,540924,22599,0.04177851232335781,12461,1140,0.09148543455581414,262704,13542,0.051548510871551254
2025-03-07,30615,2080,0.06794055201698514,662033,27844,0.0420583263976267,15731,1441,0.09160256817748395,331147,17619,0.05320597800976606,5111,403,0.07884954020739582,119581,5153,0.043092130020655456,3253,298,0.09160774669535814,67926,4034,0.05938815770102759,25504,1677,0.06575439146800502,542452,22691,0.041830429236135176,12478,1143,0.09160121814393332,263221,13585,0.05161062377241937
